年度,醫院層級,菌種名稱,抗生素名稱,分離菌株總數,通報藥敏試驗菌株總數,敏感性菌株數,非敏感性菌株數,通報藥敏試驗醫院家數
2023,醫學中心,Acinetobacter baumannii,Ampicillin/Sulbactam,4359,3069,1268,1801,20
2023,醫學中心,Acinetobacter baumannii,Amikacin,4359,2435,792,1643,20
2023,醫學中心,Acinetobacter baumannii,Cefepime,4359,3604,1132,2472,20
2023,醫學中心,Acinetobacter baumannii,Ciprofloxacin,4359,3770,1091,2679,20
2023,醫學中心,Acinetobacter baumannii,Ceftazidime,4359,3770,1167,2603,20
2023,醫學中心,Acinetobacter baumannii,Colistin,4359,1678,653,1025,17
2023,醫學中心,Acinetobacter baumannii,Gentamicin,4359,3322,1101,2221,20
2023,醫學中心,Acinetobacter baumannii,Imipenem,4359,4166,1214,2952,25
2023,醫學中心,Acinetobacter baumannii,Levofloxacin,4359,2245,890,1355,18
2023,醫學中心,Acinetobacter baumannii,Meropenem,4359,2759,715,2044,25
2023,醫學中心,Acinetobacter baumannii,Piperacillin/Tazobactam,4359,3447,811,2636,20
2023,醫學中心,Acinetobacter baumannii,Piperacillin,4359,187,54,133,17
2023,醫學中心,Acinetobacter baumannii,Tigecycline,4359,1663,1143,520,17
2023,醫學中心,Enterobacter cloacae,Amikacin,2257,1595,1578,17,17
2023,醫學中心,Enterobacter cloacae,Cefotaxime,2257,758,425,333,16
2023,醫學中心,Enterobacter cloacae,Cefepime,2257,1675,1327,348,16
2023,醫學中心,Enterobacter cloacae,Ciprofloxacin,2257,1691,1130,561,17
2023,醫學中心,Enterobacter cloacae,Ceftazidime,2257,1806,898,908,19
2023,醫學中心,Enterobacter cloacae,Ceftriaxone,2257,1608,775,833,20
2023,醫學中心,Enterobacter cloacae,Ertapenem,2257,1964,1556,408,19
2023,醫學中心,Enterobacter cloacae,Gentamicin,2257,1783,1524,259,17
2023,醫學中心,Enterobacter cloacae,Imipenem,2257,1820,1542,278,20
2023,醫學中心,Enterobacter cloacae,Levofloxacin,2257,1320,878,442,17
2023,醫學中心,Enterobacter cloacae,Meropenem,2257,762,678,84,20
2023,醫學中心,Escherichia coli,Ampicillin/Sulbactam,22037,13977,5792,8185,17
2023,醫學中心,Escherichia coli,Ampicillin,22037,6016,1903,4113,17
2023,醫學中心,Escherichia coli,Amikacin,22037,19862,19755,107,20
2023,醫學中心,Escherichia coli,Cefuroxime sodium,22037,2885,1812,1073,17
2023,醫學中心,Escherichia coli,Cefotaxime,22037,8265,5577,2688,18
2023,醫學中心,Escherichia coli,Ciprofloxacin,22037,19856,10618,9238,20
2023,醫學中心,Escherichia coli,Ceftazidime,22037,13536,10184,3352,20
2023,醫學中心,Escherichia coli,Cefazolin,22037,14009,7551,6458,17
2023,醫學中心,Escherichia coli,Ceftriaxone,22037,14660,9818,4842,20
2023,醫學中心,Escherichia coli,Ertapenem,22037,19116,18784,332,22
2023,醫學中心,Escherichia coli,Gentamicin,22037,20788,15879,4909,20
2023,醫學中心,Escherichia coli,Imipenem,22037,16483,16227,256,22
2023,醫學中心,Escherichia coli,Levofloxacin,22037,15015,7986,7029,20
2023,醫學中心,Escherichia coli,Meropenem,22037,7314,7242,72,22
2023,醫學中心,Klebsiella pneumoniae,Ampicillin/Sulbactam,11988,7073,3478,3595,17
2023,醫學中心,Klebsiella pneumoniae,Ampicillin,11988,2593,0,2593,17
2023,醫學中心,Klebsiella pneumoniae,Amikacin,11988,8766,8477,289,20
2023,醫學中心,Klebsiella pneumoniae,Cefuroxime sodium,11988,1441,793,648,17
2023,醫學中心,Klebsiella pneumoniae,Cefotaxime,11988,3885,2314,1571,18
2023,醫學中心,Klebsiella pneumoniae,Ciprofloxacin,11988,9338,5267,4071,20
2023,醫學中心,Klebsiella pneumoniae,Ceftazidime,11988,7706,4468,3238,20
2023,醫學中心,Klebsiella pneumoniae,Cefazolin,11988,7273,3034,4239,17
2023,醫學中心,Klebsiella pneumoniae,Ceftriaxone,11988,5346,3218,2128,17
2023,醫學中心,Klebsiella pneumoniae,Ertapenem,11988,10720,8969,1751,25
2023,醫學中心,Klebsiella pneumoniae,Gentamicin,11988,9705,7144,2561,20
2023,醫學中心,Klebsiella pneumoniae,Imipenem,11988,9356,7766,1590,25
2023,醫學中心,Klebsiella pneumoniae,Levofloxacin,11988,5699,3121,2578,17
2023,醫學中心,Klebsiella pneumoniae,Meropenem,11988,3822,3343,479,25
2023,醫學中心,Proteus mirabilis,Ampicillin/Sulbactam,3233,2342,1536,806,20
2023,醫學中心,Proteus mirabilis,Ampicillin,3233,859,388,471,17
2023,醫學中心,Proteus mirabilis,Amikacin,3233,2310,2247,63,17
2023,醫學中心,Proteus mirabilis,Cefuroxime sodium,3233,370,308,62,17
2023,醫學中心,Proteus mirabilis,Cefotaxime,3233,1232,1002,230,17
2023,醫學中心,Proteus mirabilis,Ciprofloxacin,3233,2310,1541,769,17
2023,醫學中心,Proteus mirabilis,Cefazolin,3233,2655,1195,1460,20
2023,醫學中心,Proteus mirabilis,Ceftriaxone,3233,1553,1338,215,17
2023,醫學中心,Proteus mirabilis,Gentamicin,3233,3092,2124,968,20
2023,醫學中心,Proteus mirabilis,Levofloxacin,3233,1922,1388,534,17
2023,醫學中心,Proteus mirabilis,Meropenem,3233,1236,1226,10,17
2023,醫學中心,Pseudomonas aeruginosa,Amikacin,8600,6140,5989,151,17
2023,醫學中心,Pseudomonas aeruginosa,Cefepime,8600,5994,5069,925,17
2023,醫學中心,Pseudomonas aeruginosa,Ciprofloxacin,8600,7626,5967,1659,20
2023,醫學中心,Pseudomonas aeruginosa,Ceftazidime,8600,7622,6300,1322,20
2023,醫學中心,Pseudomonas aeruginosa,Gentamicin,8600,7015,6393,622,20
2023,醫學中心,Pseudomonas aeruginosa,Imipenem,8600,8414,6949,1465,21
2023,醫學中心,Pseudomonas aeruginosa,Levofloxacin,8600,6183,4390,1793,20
2023,醫學中心,Pseudomonas aeruginosa,Meropenem,8600,5011,4221,790,20
2023,醫學中心,Pseudomonas aeruginosa,Piperacillin/Tazobactam,8600,7598,6021,1577,20
2023,醫學中心,Pseudomonas aeruginosa,Piperacillin,8600,754,622,132,17
2023,醫學中心,Enterococcus faecalis,Ampicillin,6560,3855,3843,12,20
2023,醫學中心,Enterococcus faecalis,Gentamicin-High,6560,4480,2775,1705,20
2023,醫學中心,Enterococcus faecalis,Vancomycin,6560,6549,6505,44,25
2023,醫學中心,Enterococcus faecium,Ampicillin,5704,3201,232,2969,20
2023,醫學中心,Enterococcus faecium,Gentamicin-High,5704,3899,2475,1424,20
2023,醫學中心,Enterococcus faecium,Vancomycin,5704,5696,2361,3335,25
2023,醫學中心,Staphylococcus aureus,Ciprofloxacin,10221,3539,2582,957,17
2023,醫學中心,Staphylococcus aureus,Oxacillin,10221,10217,5993,4224,25
2023,醫學中心,Staphylococcus aureus,Trimethoprim/Sulfamethoxazole,10221,8408,7918,490,20
2023,醫學中心,Staphylococcus aureus,Vancomycin,10221,8310,7753,557,22
2023,醫學中心,Enterococcus spp.,Ampicillin,1322,380,261,119,20
2023,醫學中心,Enterococcus spp.,Gentamicin-High,1322,1187,765,422,19
2023,醫學中心,Enterococcus spp.,Vancomycin,1322,1321,971,350,24
2023,區域醫院,Acinetobacter baumannii,Ampicillin/Sulbactam,4782,3403,1123,2280,73
2023,區域醫院,Acinetobacter baumannii,Amikacin,4782,2498,963,1535,73
2023,區域醫院,Acinetobacter baumannii,Cefepime,4782,3623,1015,2608,73
2023,區域醫院,Acinetobacter baumannii,Ciprofloxacin,4782,2468,632,1836,72
2023,區域醫院,Acinetobacter baumannii,Ceftazidime,4782,3669,950,2719,74
2023,區域醫院,Acinetobacter baumannii,Colistin,4782,927,358,569,70
2023,區域醫院,Acinetobacter baumannii,Gentamicin,4782,3512,1014,2498,73
2023,區域醫院,Acinetobacter baumannii,Imipenem,4782,3734,960,2774,80
2023,區域醫院,Acinetobacter baumannii,Levofloxacin,4782,2851,807,2044,71
2023,區域醫院,Acinetobacter baumannii,Meropenem,4782,2372,635,1737,81
2023,區域醫院,Acinetobacter baumannii,Piperacillin/Tazobactam,4782,3486,729,2757,74
2023,區域醫院,Acinetobacter baumannii,Piperacillin,4782,597,54,543,69
2023,區域醫院,Acinetobacter baumannii,Tigecycline,4782,2038,1299,739,69
2023,區域醫院,Enterobacter cloacae,Amikacin,2261,1782,1718,64,70
2023,區域醫院,Enterobacter cloacae,Cefotaxime,2261,689,365,324,68
2023,區域醫院,Enterobacter cloacae,Cefepime,2261,1743,1416,327,69
2023,區域醫院,Enterobacter cloacae,Ciprofloxacin,2261,1111,761,350,69
2023,區域醫院,Enterobacter cloacae,Ceftazidime,2261,1660,940,720,72
2023,區域醫院,Enterobacter cloacae,Ceftriaxone,2261,1245,641,604,72
2023,區域醫院,Enterobacter cloacae,Ertapenem,2261,1635,1327,308,72
2023,區域醫院,Enterobacter cloacae,Gentamicin,2261,1826,1575,251,70
2023,區域醫院,Enterobacter cloacae,Imipenem,2261,1443,1213,230,73
2023,區域醫院,Enterobacter cloacae,Levofloxacin,2261,1349,996,353,70
2023,區域醫院,Enterobacter cloacae,Meropenem,2261,839,797,42,72
2023,區域醫院,Escherichia coli,Ampicillin/Sulbactam,41563,27073,12559,14514,70
2023,區域醫院,Escherichia coli,Ampicillin,41563,17529,4060,13469,70
2023,區域醫院,Escherichia coli,Amikacin,41563,32593,32151,442,72
2023,區域醫院,Escherichia coli,Cefuroxime sodium,41563,6475,3986,2489,70
2023,區域醫院,Escherichia coli,Cefotaxime,41563,11854,7820,4034,70
2023,區域醫院,Escherichia coli,Ciprofloxacin,41563,21499,11214,10285,71
2023,區域醫院,Escherichia coli,Ceftazidime,41563,24800,18451,6349,73
2023,區域醫院,Escherichia coli,Cefazolin,41563,25717,14069,11648,70
2023,區域醫院,Escherichia coli,Ceftriaxone,41563,20106,13260,6846,73
2023,區域醫院,Escherichia coli,Ertapenem,41563,28936,27970,966,76
2023,區域醫院,Escherichia coli,Gentamicin,41563,32792,24566,8226,72
2023,區域醫院,Escherichia coli,Imipenem,41563,24668,23952,716,77
2023,區域醫院,Escherichia coli,Levofloxacin,41563,25196,13134,12062,72
2023,區域醫院,Escherichia coli,Meropenem,41563,13997,13505,492,76
2023,區域醫院,Klebsiella pneumoniae,Ampicillin/Sulbactam,17642,11206,5534,5672,71
2023,區域醫院,Klebsiella pneumoniae,Ampicillin,17642,6488,5,6483,70
2023,區域醫院,Klebsiella pneumoniae,Amikacin,17642,13259,12372,887,73
2023,區域醫院,Klebsiella pneumoniae,Cefuroxime sodium,17642,2587,1354,1233,70
2023,區域醫院,Klebsiella pneumoniae,Cefotaxime,17642,5130,2996,2134,70
2023,區域醫院,Klebsiella pneumoniae,Ciprofloxacin,17642,9193,5212,3981,72
2023,區域醫院,Klebsiella pneumoniae,Ceftazidime,17642,10850,6433,4417,74
2023,區域醫院,Klebsiella pneumoniae,Cefazolin,17642,11184,5531,5653,71
2023,區域醫院,Klebsiella pneumoniae,Ceftriaxone,17642,7426,4633,2793,72
2023,區域醫院,Klebsiella pneumoniae,Ertapenem,17642,12241,9580,2661,79
2023,區域醫院,Klebsiella pneumoniae,Gentamicin,17642,13382,9512,3870,73
2023,區域醫院,Klebsiella pneumoniae,Imipenem,17642,10902,8799,2103,80
2023,區域醫院,Klebsiella pneumoniae,Levofloxacin,17642,9324,5448,3876,71
2023,區域醫院,Klebsiella pneumoniae,Meropenem,17642,6718,5713,1005,81
2023,區域醫院,Proteus mirabilis,Ampicillin/Sulbactam,6268,4877,2654,2223,72
2023,區域醫院,Proteus mirabilis,Ampicillin,6268,2619,878,1741,70
2023,區域醫院,Proteus mirabilis,Amikacin,6268,4961,4412,549,70
2023,區域醫院,Proteus mirabilis,Cefuroxime sodium,6268,1273,871,402,70
2023,區域醫院,Proteus mirabilis,Cefotaxime,6268,2193,1587,606,69
2023,區域醫院,Proteus mirabilis,Ciprofloxacin,6268,3380,1662,1718,69
2023,區域醫院,Proteus mirabilis,Cefazolin,6268,4803,1977,2826,72
2023,區域醫院,Proteus mirabilis,Ceftriaxone,6268,2861,2215,646,70
2023,區域醫院,Proteus mirabilis,Gentamicin,6268,5339,3040,2299,72
2023,區域醫院,Proteus mirabilis,Levofloxacin,6268,3595,1975,1620,70
2023,區域醫院,Proteus mirabilis,Meropenem,6268,2801,2723,78,70
2023,區域醫院,Pseudomonas aeruginosa,Amikacin,12284,8865,8521,344,70
2023,區域醫院,Pseudomonas aeruginosa,Cefepime,12284,9007,7726,1281,70
2023,區域醫院,Pseudomonas aeruginosa,Ciprofloxacin,12284,7578,5601,1977,71
2023,區域醫院,Pseudomonas aeruginosa,Ceftazidime,12284,9880,8239,1641,73
2023,區域醫院,Pseudomonas aeruginosa,Gentamicin,12284,9712,8348,1364,72
2023,區域醫院,Pseudomonas aeruginosa,Imipenem,12284,8710,7068,1642,76
2023,區域醫院,Pseudomonas aeruginosa,Levofloxacin,12284,8757,5967,2790,72
2023,區域醫院,Pseudomonas aeruginosa,Meropenem,12284,7036,5882,1154,78
2023,區域醫院,Pseudomonas aeruginosa,Piperacillin/Tazobactam,12284,9522,7657,1865,73
2023,區域醫院,Pseudomonas aeruginosa,Piperacillin,12284,1245,878,367,68
2023,區域醫院,Enterococcus faecalis,Ampicillin,6641,4002,3950,52,73
2023,區域醫院,Enterococcus faecalis,Gentamicin-High,6641,5230,2943,2287,74
2023,區域醫院,Enterococcus faecalis,Vancomycin,6641,6470,6412,58,81
2023,區域醫院,Enterococcus faecium,Ampicillin,5188,3103,162,2941,73
2023,區域醫院,Enterococcus faecium,Gentamicin-High,5188,4166,2416,1750,74
2023,區域醫院,Enterococcus faecium,Vancomycin,5188,5054,2049,3005,81
2023,區域醫院,Staphylococcus aureus,Ciprofloxacin,13169,3081,1910,1171,70
2023,區域醫院,Staphylococcus aureus,Oxacillin,13169,11734,5879,5855,81
2023,區域醫院,Staphylococcus aureus,Trimethoprim/Sulfamethoxazole,13169,10997,9920,1077,73
2023,區域醫院,Staphylococcus aureus,Vancomycin,13169,10876,10871,5,75
2023,區域醫院,Enterococcus spp.,Ampicillin,2512,1901,1000,901,67
2023,區域醫院,Enterococcus spp.,Gentamicin-High,2512,1773,1147,626,66
2023,區域醫院,Enterococcus spp.,Vancomycin,2512,2213,1704,509,71
2023,地區醫院,Acinetobacter baumannii,Ampicillin/Sulbactam,2970,2131,747,1384,205
2023,地區醫院,Acinetobacter baumannii,Amikacin,2970,2233,479,1754,206
2023,地區醫院,Acinetobacter baumannii,Cefepime,2970,2371,367,2004,206
2023,地區醫院,Acinetobacter baumannii,Ciprofloxacin,2970,1815,182,1633,205
2023,地區醫院,Acinetobacter baumannii,Ceftazidime,2970,2501,385,2116,206
2023,地區醫院,Acinetobacter baumannii,Colistin,2970,1264,950,314,198
2023,地區醫院,Acinetobacter baumannii,Gentamicin,2970,2437,452,1985,206
2023,地區醫院,Acinetobacter baumannii,Imipenem,2970,2225,387,1838,213
2023,地區醫院,Acinetobacter baumannii,Levofloxacin,2970,1863,187,1676,202
2023,地區醫院,Acinetobacter baumannii,Meropenem,2970,1722,232,1490,211
2023,地區醫院,Acinetobacter baumannii,Piperacillin/Tazobactam,2970,2385,249,2136,204
2023,地區醫院,Acinetobacter baumannii,Piperacillin,2970,252,23,229,201
2023,地區醫院,Acinetobacter baumannii,Tigecycline,2970,1234,934,300,201
2023,地區醫院,Enterobacter cloacae,Amikacin,646,582,543,39,186
2023,地區醫院,Enterobacter cloacae,Cefotaxime,646,252,123,129,185
2023,地區醫院,Enterobacter cloacae,Cefepime,646,551,402,149,186
2023,地區醫院,Enterobacter cloacae,Ciprofloxacin,646,488,291,197,186
2023,地區醫院,Enterobacter cloacae,Ceftazidime,646,547,315,232,189
2023,地區醫院,Enterobacter cloacae,Ceftriaxone,646,396,194,202,189
2023,地區醫院,Enterobacter cloacae,Ertapenem,646,471,377,94,187
2023,地區醫院,Enterobacter cloacae,Gentamicin,646,609,470,139,186
2023,地區醫院,Enterobacter cloacae,Imipenem,646,464,378,86,189
2023,地區醫院,Enterobacter cloacae,Levofloxacin,646,433,240,193,186
2023,地區醫院,Enterobacter cloacae,Meropenem,646,348,303,45,188
2023,地區醫院,Escherichia coli,Ampicillin/Sulbactam,18730,12727,5322,7405,209
2023,地區醫院,Escherichia coli,Ampicillin,18730,10344,2017,8327,209
2023,地區醫院,Escherichia coli,Amikacin,18730,17655,16896,759,213
2023,地區醫院,Escherichia coli,Cefuroxime sodium,18730,2702,1564,1138,208
2023,地區醫院,Escherichia coli,Cefotaxime,18730,6041,3558,2483,207
2023,地區醫院,Escherichia coli,Ciprofloxacin,18730,14192,6238,7954,211
2023,地區醫院,Escherichia coli,Ceftazidime,18730,15305,9553,5752,212
2023,地區醫院,Escherichia coli,Cefazolin,18730,14550,6062,8488,208
2023,地區醫院,Escherichia coli,Ceftriaxone,18730,12766,6795,5971,212
2023,地區醫院,Escherichia coli,Ertapenem,18730,12005,11110,895,210
2023,地區醫院,Escherichia coli,Gentamicin,18730,17870,12151,5719,212
2023,地區醫院,Escherichia coli,Imipenem,18730,12201,11349,852,214
2023,地區醫院,Escherichia coli,Levofloxacin,18730,12112,4987,7125,212
2023,地區醫院,Escherichia coli,Meropenem,18730,10546,9731,815,214
2023,地區醫院,Klebsiella pneumoniae,Ampicillin/Sulbactam,9257,5987,2498,3489,213
2023,地區醫院,Klebsiella pneumoniae,Ampicillin,9257,4291,153,4138,213
2023,地區醫院,Klebsiella pneumoniae,Amikacin,9257,7755,6739,1016,215
2023,地區醫院,Klebsiella pneumoniae,Cefuroxime sodium,9257,948,435,513,211
2023,地區醫院,Klebsiella pneumoniae,Cefotaxime,9257,2219,1170,1049,210
2023,地區醫院,Klebsiella pneumoniae,Ciprofloxacin,9257,6106,3189,2917,215
2023,地區醫院,Klebsiella pneumoniae,Ceftazidime,9257,7178,3802,3376,215
2023,地區醫院,Klebsiella pneumoniae,Cefazolin,9257,6496,2368,4128,211
2023,地區醫院,Klebsiella pneumoniae,Ceftriaxone,9257,5829,3189,2640,212
2023,地區醫院,Klebsiella pneumoniae,Ertapenem,9257,5253,4020,1233,218
2023,地區醫院,Klebsiella pneumoniae,Gentamicin,9257,7631,5080,2551,215
2023,地區醫院,Klebsiella pneumoniae,Imipenem,9257,6397,5114,1283,222
2023,地區醫院,Klebsiella pneumoniae,Levofloxacin,9257,5635,2889,2746,212
2023,地區醫院,Klebsiella pneumoniae,Meropenem,9257,4440,3520,920,221
2023,地區醫院,Proteus mirabilis,Ampicillin/Sulbactam,5254,4084,1617,2467,209
2023,地區醫院,Proteus mirabilis,Ampicillin,5254,3369,538,2831,207
2023,地區醫院,Proteus mirabilis,Amikacin,5254,5098,4089,1009,207
2023,地區醫院,Proteus mirabilis,Cefuroxime sodium,5254,454,293,161,206
2023,地區醫院,Proteus mirabilis,Cefotaxime,5254,1505,904,601,204
2023,地區醫院,Proteus mirabilis,Ciprofloxacin,5254,3829,1283,2546,206
2023,地區醫院,Proteus mirabilis,Cefazolin,5254,4062,967,3095,207
2023,地區醫院,Proteus mirabilis,Ceftriaxone,5254,4043,2727,1316,206
2023,地區醫院,Proteus mirabilis,Gentamicin,5254,4950,1693,3257,210
2023,地區醫院,Proteus mirabilis,Levofloxacin,5254,3718,1453,2265,207
2023,地區醫院,Proteus mirabilis,Meropenem,5254,3153,2998,155,206
2023,地區醫院,Pseudomonas aeruginosa,Amikacin,6772,6510,5927,583,201
2023,地區醫院,Pseudomonas aeruginosa,Cefepime,6772,5728,4434,1294,204
2023,地區醫院,Pseudomonas aeruginosa,Ciprofloxacin,6772,5104,2772,2332,206
2023,地區醫院,Pseudomonas aeruginosa,Ceftazidime,6772,6527,4986,1541,207
2023,地區醫院,Pseudomonas aeruginosa,Gentamicin,6772,6495,4529,1966,207
2023,地區醫院,Pseudomonas aeruginosa,Imipenem,6772,5020,3664,1356,207
2023,地區醫院,Pseudomonas aeruginosa,Levofloxacin,6772,5235,2580,2655,206
2023,地區醫院,Pseudomonas aeruginosa,Meropenem,6772,4231,3036,1195,207
2023,地區醫院,Pseudomonas aeruginosa,Piperacillin/Tazobactam,6772,6314,4367,1947,206
2023,地區醫院,Pseudomonas aeruginosa,Piperacillin,6772,897,647,250,203
2023,地區醫院,Enterococcus faecalis,Ampicillin,2031,1474,1427,47,187
2023,地區醫院,Enterococcus faecalis,Gentamicin-High,2031,1386,698,688,186
2023,地區醫院,Enterococcus faecalis,Vancomycin,2031,2024,1972,52,192
2023,地區醫院,Enterococcus faecium,Ampicillin,1086,771,54,717,184
2023,地區醫院,Enterococcus faecium,Gentamicin-High,1086,705,408,297,183
2023,地區醫院,Enterococcus faecium,Vancomycin,1086,1043,411,632,188
2023,地區醫院,Staphylococcus aureus,Ciprofloxacin,7015,2707,1191,1516,212
2023,地區醫院,Staphylococcus aureus,Oxacillin,7015,6766,2593,4173,223
2023,地區醫院,Staphylococcus aureus,Trimethoprim/Sulfamethoxazole,7015,5867,5214,653,216
2023,地區醫院,Staphylococcus aureus,Vancomycin,7015,6375,6274,101,219
2023,地區醫院,Enterococcus spp.,Ampicillin,1725,808,455,353,193
2023,地區醫院,Enterococcus spp.,Gentamicin-High,1725,1080,611,469,194
2023,地區醫院,Enterococcus spp.,Vancomycin,1725,1722,1290,432,200
2022,醫學中心,Acinetobacter baumannii,Ampicillin/Sulbactam,18509,12602,5588,7014,19
2022,醫學中心,Acinetobacter baumannii,Amikacin,18509,9238,3444,5794,19
2022,醫學中心,Acinetobacter baumannii,Cefepime,18509,14483,5290,9193,19
2022,醫學中心,Acinetobacter baumannii,Ciprofloxacin,18509,14876,5022,9854,19
2022,醫學中心,Acinetobacter baumannii,Ceftazidime,18509,14821,5300,9521,19
2022,醫學中心,Acinetobacter baumannii,Colistin,18509,6638,2128,4510,16
2022,醫學中心,Acinetobacter baumannii,Gentamicin,18509,13212,4924,8288,19
2022,醫學中心,Acinetobacter baumannii,Imipenem,18509,17692,6183,11509,24
2022,醫學中心,Acinetobacter baumannii,Levofloxacin,18509,9387,3905,5482,17
2022,醫學中心,Acinetobacter baumannii,Meropenem,18509,10462,3596,6866,24
2022,醫學中心,Acinetobacter baumannii,Piperacillin/Tazobactam,18509,13074,4004,9070,19
2022,醫學中心,Acinetobacter baumannii,Piperacillin,18509,936,347,589,16
2022,醫學中心,Acinetobacter baumannii,Tigecycline,18509,7115,4663,2452,16
2022,醫學中心,Enterobacter cloacae,Amikacin,8525,6197,6117,80,16
2022,醫學中心,Enterobacter cloacae,Cefotaxime,8525,3701,1889,1812,17
2022,醫學中心,Enterobacter cloacae,Cefepime,8525,6895,5591,1304,16
2022,醫學中心,Enterobacter cloacae,Ciprofloxacin,8525,6613,4684,1929,16
2022,醫學中心,Enterobacter cloacae,Ceftazidime,8525,7286,3903,3383,19
2022,醫學中心,Enterobacter cloacae,Ceftriaxone,8525,5071,2627,2444,19
2022,醫學中心,Enterobacter cloacae,Ertapenem,8525,7912,6454,1458,19
2022,醫學中心,Enterobacter cloacae,Gentamicin,8525,6993,5973,1020,16
2022,醫學中心,Enterobacter cloacae,Imipenem,8525,6869,5918,951,19
2022,醫學中心,Enterobacter cloacae,Levofloxacin,8525,5447,3796,1651,16
2022,醫學中心,Enterobacter cloacae,Meropenem,8525,3469,3145,324,19
2022,醫學中心,Escherichia coli,Ampicillin/Sulbactam,83219,53641,22501,31140,16
2022,醫學中心,Escherichia coli,Ampicillin,83219,13380,3233,10147,16
2022,醫學中心,Escherichia coli,Amikacin,83219,72204,71798,406,19
2022,醫學中心,Escherichia coli,Cefuroxime sodium,83219,11309,7025,4284,16
2022,醫學中心,Escherichia coli,Cefotaxime,83219,32600,21940,10660,17
2022,醫學中心,Escherichia coli,Ciprofloxacin,83219,75162,41016,34146,19
2022,醫學中心,Escherichia coli,Ceftazidime,83219,53672,40340,13332,19
2022,醫學中心,Escherichia coli,Cefazolin,83219,51774,25338,26436,16
2022,醫學中心,Escherichia coli,Ceftriaxone,83219,49326,32477,16849,19
2022,醫學中心,Escherichia coli,Ertapenem,83219,74820,73643,1177,19
2022,醫學中心,Escherichia coli,Gentamicin,83219,78805,59979,18826,19
2022,醫學中心,Escherichia coli,Imipenem,83219,61059,60282,777,19
2022,醫學中心,Escherichia coli,Levofloxacin,83219,61027,34450,26577,19
2022,醫學中心,Escherichia coli,Meropenem,83219,27728,27491,237,19
2022,醫學中心,Klebsiella pneumoniae,Ampicillin/Sulbactam,48920,28568,14762,13806,16
2022,醫學中心,Klebsiella pneumoniae,Ampicillin,48920,7550,293,7257,16
2022,醫學中心,Klebsiella pneumoniae,Amikacin,48920,34851,33638,1213,19
2022,醫學中心,Klebsiella pneumoniae,Cefuroxime sodium,48920,5730,3097,2633,16
2022,醫學中心,Klebsiella pneumoniae,Cefotaxime,48920,16252,10367,5885,17
2022,醫學中心,Klebsiella pneumoniae,Ciprofloxacin,48920,37908,22566,15342,19
2022,醫學中心,Klebsiella pneumoniae,Ceftazidime,48920,32334,19399,12935,19
2022,醫學中心,Klebsiella pneumoniae,Cefazolin,48920,28802,11484,17318,16
2022,醫學中心,Klebsiella pneumoniae,Ceftriaxone,48920,18378,11079,7299,16
2022,醫學中心,Klebsiella pneumoniae,Ertapenem,48920,44842,38601,6241,24
2022,醫學中心,Klebsiella pneumoniae,Gentamicin,48920,39340,28632,10708,19
2022,醫學中心,Klebsiella pneumoniae,Imipenem,48920,37889,32162,5727,24
2022,醫學中心,Klebsiella pneumoniae,Levofloxacin,48920,22010,12931,9079,16
2022,醫學中心,Klebsiella pneumoniae,Meropenem,48920,15382,13946,1436,24
2022,醫學中心,Proteus mirabilis,Ampicillin/Sulbactam,12133,9446,6282,3164,19
2022,醫學中心,Proteus mirabilis,Ampicillin,12133,2229,880,1349,16
2022,醫學中心,Proteus mirabilis,Amikacin,12133,9110,8852,258,16
2022,醫學中心,Proteus mirabilis,Cefuroxime sodium,12133,1394,1183,211,16
2022,醫學中心,Proteus mirabilis,Cefotaxime,12133,5071,4161,910,16
2022,醫學中心,Proteus mirabilis,Ciprofloxacin,12133,9105,6050,3055,16
2022,醫學中心,Proteus mirabilis,Cefazolin,12133,10798,4315,6483,19
2022,醫學中心,Proteus mirabilis,Ceftriaxone,12133,4846,4089,757,16
2022,醫學中心,Proteus mirabilis,Gentamicin,12133,11952,8380,3572,19
2022,醫學中心,Proteus mirabilis,Levofloxacin,12133,7896,5440,2456,16
2022,醫學中心,Proteus mirabilis,Meropenem,12133,5274,5179,95,16
2022,醫學中心,Pseudomonas aeruginosa,Amikacin,35255,24956,24363,593,16
2022,醫學中心,Pseudomonas aeruginosa,Cefepime,35255,24352,20837,3515,16
2022,醫學中心,Pseudomonas aeruginosa,Ciprofloxacin,35255,31262,24785,6477,19
2022,醫學中心,Pseudomonas aeruginosa,Ceftazidime,35255,31292,26192,5100,19
2022,醫學中心,Pseudomonas aeruginosa,Gentamicin,35255,28759,25905,2854,19
2022,醫學中心,Pseudomonas aeruginosa,Imipenem,35255,32394,26791,5603,20
2022,醫學中心,Pseudomonas aeruginosa,Levofloxacin,35255,25032,18071,6961,19
2022,醫學中心,Pseudomonas aeruginosa,Meropenem,35255,21253,17740,3513,20
2022,醫學中心,Pseudomonas aeruginosa,Piperacillin/Tazobactam,35255,31191,24860,6331,19
2022,醫學中心,Pseudomonas aeruginosa,Piperacillin,35255,3209,2596,613,16
2022,醫學中心,Enterococcus faecalis,Ampicillin,25019,15241,15195,46,19
2022,醫學中心,Enterococcus faecalis,Gentamicin-High,25019,16385,10114,6271,19
2022,醫學中心,Enterococcus faecalis,Vancomycin,25019,24828,24387,441,24
2022,醫學中心,Enterococcus faecium,Ampicillin,20589,11655,803,10852,19
2022,醫學中心,Enterococcus faecium,Gentamicin-High,20589,13790,8605,5185,19
2022,醫學中心,Enterococcus faecium,Vancomycin,20589,20524,8137,12387,24
2022,醫學中心,Staphylococcus aureus,Ciprofloxacin,38473,13617,10053,3564,16
2022,醫學中心,Staphylococcus aureus,Oxacillin,38473,38413,21892,16521,24
2022,醫學中心,Staphylococcus aureus,Trimethoprim/Sulfamethoxazole,38473,31056,28716,2340,19
2022,醫學中心,Staphylococcus aureus,Vancomycin,38473,31527,31513,14,20
2022,醫學中心,Enterococcus spp.,Ampicillin,3871,1521,1076,445,19
2022,醫學中心,Enterococcus spp.,Gentamicin-High,3871,3213,2260,953,19
2022,醫學中心,Enterococcus spp.,Vancomycin,3871,3860,2773,1087,23
2022,區域醫院,Acinetobacter baumannii,Ampicillin/Sulbactam,21134,16616,5999,10617,74
2022,區域醫院,Acinetobacter baumannii,Amikacin,21134,11975,4409,7566,74
2022,區域醫院,Acinetobacter baumannii,Cefepime,21134,16733,4951,11782,74
2022,區域醫院,Acinetobacter baumannii,Ciprofloxacin,21134,12197,3097,9100,74
2022,區域醫院,Acinetobacter baumannii,Ceftazidime,21134,17692,4701,12991,74
2022,區域醫院,Acinetobacter baumannii,Colistin,21134,5204,3321,1883,72
2022,區域醫院,Acinetobacter baumannii,Gentamicin,21134,17067,5284,11783,74
2022,區域醫院,Acinetobacter baumannii,Imipenem,21134,17799,5122,12677,79
2022,區域醫院,Acinetobacter baumannii,Levofloxacin,21134,13036,4069,8967,72
2022,區域醫院,Acinetobacter baumannii,Meropenem,21134,11231,3182,8049,79
2022,區域醫院,Acinetobacter baumannii,Piperacillin/Tazobactam,21134,16663,3895,12768,74
2022,區域醫院,Acinetobacter baumannii,Piperacillin,21134,2861,416,2445,72
2022,區域醫院,Acinetobacter baumannii,Tigecycline,21134,9957,6820,3137,72
2022,區域醫院,Enterobacter cloacae,Amikacin,10074,7801,7470,331,70
2022,區域醫院,Enterobacter cloacae,Cefotaxime,10074,3183,1488,1695,71
2022,區域醫院,Enterobacter cloacae,Cefepime,10074,7471,6284,1187,70
2022,區域醫院,Enterobacter cloacae,Ciprofloxacin,10074,5522,4009,1513,70
2022,區域醫院,Enterobacter cloacae,Ceftazidime,10074,7144,4308,2836,72
2022,區域醫院,Enterobacter cloacae,Ceftriaxone,10074,5775,3247,2528,72
2022,區域醫院,Enterobacter cloacae,Ertapenem,10074,7609,6326,1283,73
2022,區域醫院,Enterobacter cloacae,Gentamicin,10074,8049,6979,1070,70
2022,區域醫院,Enterobacter cloacae,Imipenem,10074,6400,5514,886,73
2022,區域醫院,Enterobacter cloacae,Levofloxacin,10074,5718,4458,1260,70
2022,區域醫院,Enterobacter cloacae,Meropenem,10074,3437,3199,238,73
2022,區域醫院,Escherichia coli,Ampicillin/Sulbactam,166936,109269,51781,57488,70
2022,區域醫院,Escherichia coli,Ampicillin,166936,70735,18084,52651,70
2022,區域醫院,Escherichia coli,Amikacin,166936,135850,133878,1972,72
2022,區域醫院,Escherichia coli,Cefuroxime sodium,166936,31510,20289,11221,70
2022,區域醫院,Escherichia coli,Cefotaxime,166936,49080,32948,16132,71
2022,區域醫院,Escherichia coli,Ciprofloxacin,166936,96801,52329,44472,72
2022,區域醫院,Escherichia coli,Ceftazidime,166936,103886,78416,25470,72
2022,區域醫院,Escherichia coli,Cefazolin,166936,109213,61732,47481,70
2022,區域醫院,Escherichia coli,Ceftriaxone,166936,88141,58531,29610,72
2022,區域醫院,Escherichia coli,Ertapenem,166936,119835,116363,3472,76
2022,區域醫院,Escherichia coli,Gentamicin,166936,138197,105091,33106,72
2022,區域醫院,Escherichia coli,Imipenem,166936,102760,100244,2516,76
2022,區域醫院,Escherichia coli,Levofloxacin,166936,98785,53827,44958,72
2022,區域醫院,Escherichia coli,Meropenem,166936,58730,57174,1556,75
2022,區域醫院,Klebsiella pneumoniae,Ampicillin/Sulbactam,73854,46642,23281,23361,72
2022,區域醫院,Klebsiella pneumoniae,Ampicillin,73854,26826,762,26064,72
2022,區域醫院,Klebsiella pneumoniae,Amikacin,73854,57056,53034,4022,74
2022,區域醫院,Klebsiella pneumoniae,Cefuroxime sodium,73854,12825,7246,5579,72
2022,區域醫院,Klebsiella pneumoniae,Cefotaxime,73854,22073,12361,9712,72
2022,區域醫院,Klebsiella pneumoniae,Ciprofloxacin,73854,42134,24164,17970,74
2022,區域醫院,Klebsiella pneumoniae,Ceftazidime,73854,46717,27652,19065,74
2022,區域醫院,Klebsiella pneumoniae,Cefazolin,73854,47615,23615,24000,72
2022,區域醫院,Klebsiella pneumoniae,Ceftriaxone,73854,32250,20773,11477,72
2022,區域醫院,Klebsiella pneumoniae,Ertapenem,73854,51650,41779,9871,78
2022,區域醫院,Klebsiella pneumoniae,Gentamicin,73854,57863,40918,16945,74
2022,區域醫院,Klebsiella pneumoniae,Imipenem,73854,47743,39207,8536,79
2022,區域醫院,Klebsiella pneumoniae,Levofloxacin,73854,37907,22729,15178,72
2022,區域醫院,Klebsiella pneumoniae,Meropenem,73854,28306,23664,4642,79
2022,區域醫院,Proteus mirabilis,Ampicillin/Sulbactam,43068,19878,11225,8653,72
2022,區域醫院,Proteus mirabilis,Ampicillin,43068,11034,3807,7227,70
2022,區域醫院,Proteus mirabilis,Amikacin,43068,20910,18506,2404,70
2022,區域醫院,Proteus mirabilis,Cefuroxime sodium,43068,5321,3909,1412,70
2022,區域醫院,Proteus mirabilis,Cefotaxime,43068,9454,6637,2817,70
2022,區域醫院,Proteus mirabilis,Ciprofloxacin,43068,15105,7790,7315,70
2022,區域醫院,Proteus mirabilis,Cefazolin,43068,20263,8115,12148,72
2022,區域醫院,Proteus mirabilis,Ceftriaxone,43068,12313,9522,2791,70
2022,區域醫院,Proteus mirabilis,Gentamicin,43068,22265,12726,9539,72
2022,區域醫院,Proteus mirabilis,Levofloxacin,43068,14500,8445,6055,70
2022,區域醫院,Proteus mirabilis,Meropenem,43068,11572,11388,184,71
2022,區域醫院,Pseudomonas aeruginosa,Amikacin,51654,37357,35444,1913,70
2022,區域醫院,Pseudomonas aeruginosa,Cefepime,51654,37822,31913,5909,70
2022,區域醫院,Pseudomonas aeruginosa,Ciprofloxacin,51654,34594,25752,8842,72
2022,區域醫院,Pseudomonas aeruginosa,Ceftazidime,51654,42083,35289,6794,72
2022,區域醫院,Pseudomonas aeruginosa,Gentamicin,51654,42007,36234,5773,72
2022,區域醫院,Pseudomonas aeruginosa,Imipenem,51654,38481,31784,6697,75
2022,區域醫院,Pseudomonas aeruginosa,Levofloxacin,51654,35960,24820,11140,72
2022,區域醫院,Pseudomonas aeruginosa,Meropenem,51654,28237,23682,4555,77
2022,區域醫院,Pseudomonas aeruginosa,Piperacillin/Tazobactam,51654,41136,33425,7711,72
2022,區域醫院,Pseudomonas aeruginosa,Piperacillin,51654,6273,4767,1506,70
2022,區域醫院,Enterococcus faecalis,Ampicillin,26225,16531,16219,312,74
2022,區域醫院,Enterococcus faecalis,Gentamicin-High,26225,20996,11812,9184,74
2022,區域醫院,Enterococcus faecalis,Vancomycin,26225,25621,25143,478,80
2022,區域醫院,Enterococcus faecium,Ampicillin,18846,12174,751,11423,74
2022,區域醫院,Enterococcus faecium,Gentamicin-High,18846,15209,8613,6596,74
2022,區域醫院,Enterococcus faecium,Vancomycin,18846,18302,6630,11672,80
2022,區域醫院,Staphylococcus aureus,Ciprofloxacin,52223,12851,7976,4875,72
2022,區域醫院,Staphylococcus aureus,Oxacillin,52223,47854,24177,23677,80
2022,區域醫院,Staphylococcus aureus,Trimethoprim/Sulfamethoxazole,52223,44131,39915,4216,74
2022,區域醫院,Staphylococcus aureus,Vancomycin,52223,42109,41505,604,75
2022,區域醫院,Enterococcus spp.,Ampicillin,7914,5683,3370,2313,69
2022,區域醫院,Enterococcus spp.,Gentamicin-High,7914,5141,3312,1829,69
2022,區域醫院,Enterococcus spp.,Vancomycin,7914,7083,5433,1650,72
2022,地區醫院,Acinetobacter baumannii,Ampicillin/Sulbactam,112433,8538,2761,5777,209
2022,地區醫院,Acinetobacter baumannii,Amikacin,112433,8892,2043,6849,210
2022,地區醫院,Acinetobacter baumannii,Cefepime,112433,9769,1631,8138,210
2022,地區醫院,Acinetobacter baumannii,Ciprofloxacin,112433,7714,1052,6662,210
2022,地區醫院,Acinetobacter baumannii,Ceftazidime,112433,10472,1717,8755,210
2022,地區醫院,Acinetobacter baumannii,Colistin,112433,4623,3403,1220,206
2022,地區醫院,Acinetobacter baumannii,Gentamicin,112433,10132,1934,8198,210
2022,地區醫院,Acinetobacter baumannii,Imipenem,112433,9220,2049,7171,217
2022,地區醫院,Acinetobacter baumannii,Levofloxacin,112433,7563,988,6575,207
2022,地區醫院,Acinetobacter baumannii,Meropenem,112433,6583,1385,5198,216
2022,地區醫院,Acinetobacter baumannii,Piperacillin/Tazobactam,112433,10135,1491,8644,209
2022,地區醫院,Acinetobacter baumannii,Piperacillin,112433,1123,102,1021,206
2022,地區醫院,Acinetobacter baumannii,Tigecycline,112433,4374,3160,1214,206
2022,地區醫院,Enterobacter cloacae,Amikacin,2624,2278,2112,166,192
2022,地區醫院,Enterobacter cloacae,Cefotaxime,2624,1075,601,474,191
2022,地區醫院,Enterobacter cloacae,Cefepime,2624,2179,1671,508,192
2022,地區醫院,Enterobacter cloacae,Ciprofloxacin,2624,2034,1346,688,192
2022,地區醫院,Enterobacter cloacae,Ceftazidime,2624,2182,1337,845,194
2022,地區醫院,Enterobacter cloacae,Ceftriaxone,2624,1608,895,713,194
2022,地區醫院,Enterobacter cloacae,Ertapenem,2624,2041,1685,356,194
2022,地區醫院,Enterobacter cloacae,Gentamicin,2624,2464,1945,519,192
2022,地區醫院,Enterobacter cloacae,Imipenem,2624,1921,1615,306,196
2022,地區醫院,Enterobacter cloacae,Levofloxacin,2624,1848,1225,623,192
2022,地區醫院,Enterobacter cloacae,Meropenem,2624,1433,1265,168,195
2022,地區醫院,Escherichia coli,Ampicillin/Sulbactam,474934,50013,22246,27767,207
2022,地區醫院,Escherichia coli,Ampicillin,474934,42086,9444,32642,206
2022,地區醫院,Escherichia coli,Amikacin,474934,69302,66225,3077,210
2022,地區醫院,Escherichia coli,Cefuroxime sodium,474934,12594,7530,5064,206
2022,地區醫院,Escherichia coli,Cefotaxime,474934,23756,15093,8663,205
2022,地區醫院,Escherichia coli,Ciprofloxacin,474934,56224,26999,29225,210
2022,地區醫院,Escherichia coli,Ceftazidime,474934,58092,38725,19367,210
2022,地區醫院,Escherichia coli,Cefazolin,474934,56435,25405,31030,207
2022,地區醫院,Escherichia coli,Ceftriaxone,474934,50890,28935,21955,210
2022,地區醫院,Escherichia coli,Ertapenem,474934,47603,44278,3325,212
2022,地區醫院,Escherichia coli,Gentamicin,474934,69401,49310,20091,210
2022,地區醫院,Escherichia coli,Imipenem,474934,49145,45808,3337,214
2022,地區醫院,Escherichia coli,Levofloxacin,474934,47581,21650,25931,209
2022,地區醫院,Escherichia coli,Meropenem,474934,37259,35165,2094,215
2022,地區醫院,Klebsiella pneumoniae,Ampicillin/Sulbactam,35501,22464,9723,12741,210
2022,地區醫院,Klebsiella pneumoniae,Ampicillin,35501,18183,947,17236,211
2022,地區醫院,Klebsiella pneumoniae,Amikacin,35501,29821,25885,3936,213
2022,地區醫院,Klebsiella pneumoniae,Cefuroxime sodium,35501,4639,2342,2297,210
2022,地區醫院,Klebsiella pneumoniae,Cefotaxime,35501,9319,5424,3895,209
2022,地區醫院,Klebsiella pneumoniae,Ciprofloxacin,35501,23804,12972,10832,213
2022,地區醫院,Klebsiella pneumoniae,Ceftazidime,35501,26609,14757,11852,213
2022,地區醫院,Klebsiella pneumoniae,Cefazolin,35501,24886,9902,14984,210
2022,地區醫院,Klebsiella pneumoniae,Ceftriaxone,35501,22064,12242,9822,210
2022,地區醫院,Klebsiella pneumoniae,Ertapenem,35501,20972,16195,4777,217
2022,地區醫院,Klebsiella pneumoniae,Gentamicin,35501,30052,20097,9955,213
2022,地區醫院,Klebsiella pneumoniae,Imipenem,35501,25039,19895,5144,220
2022,地區醫院,Klebsiella pneumoniae,Levofloxacin,35501,20495,11384,9111,210
2022,地區醫院,Klebsiella pneumoniae,Meropenem,35501,16107,13247,2860,220
2022,地區醫院,Proteus mirabilis,Ampicillin/Sulbactam,20582,15322,6708,8614,207
2022,地區醫院,Proteus mirabilis,Ampicillin,20582,12618,2236,10382,205
2022,地區醫院,Proteus mirabilis,Amikacin,20582,19408,15112,4296,205
2022,地區醫院,Proteus mirabilis,Cefuroxime sodium,20582,2445,1553,892,205
2022,地區醫院,Proteus mirabilis,Cefotaxime,20582,5504,3543,1961,204
2022,地區醫院,Proteus mirabilis,Ciprofloxacin,20582,14634,5251,9383,205
2022,地區醫院,Proteus mirabilis,Cefazolin,20582,14979,3621,11358,207
2022,地區醫院,Proteus mirabilis,Ceftriaxone,20582,15062,10192,4870,205
2022,地區醫院,Proteus mirabilis,Gentamicin,20582,19638,7018,12620,208
2022,地區醫院,Proteus mirabilis,Levofloxacin,20582,13832,5416,8416,205
2022,地區醫院,Proteus mirabilis,Meropenem,20582,10622,10101,521,206
2022,地區醫院,Pseudomonas aeruginosa,Amikacin,28868,27175,24312,2863,205
2022,地區醫院,Pseudomonas aeruginosa,Cefepime,28868,24780,19088,5692,206
2022,地區醫院,Pseudomonas aeruginosa,Ciprofloxacin,28868,20859,11443,9416,209
2022,地區醫院,Pseudomonas aeruginosa,Ceftazidime,28868,27034,20868,6166,209
2022,地區醫院,Pseudomonas aeruginosa,Gentamicin,28868,27896,18962,8934,209
2022,地區醫院,Pseudomonas aeruginosa,Imipenem,28868,20776,15106,5670,210
2022,地區醫院,Pseudomonas aeruginosa,Levofloxacin,28868,22314,10906,11408,207
2022,地區醫院,Pseudomonas aeruginosa,Meropenem,28868,16973,12360,4613,211
2022,地區醫院,Pseudomonas aeruginosa,Piperacillin/Tazobactam,28868,27008,18954,8054,208
2022,地區醫院,Pseudomonas aeruginosa,Piperacillin,28868,3617,2259,1358,205
2022,地區醫院,Enterococcus faecalis,Ampicillin,107772,5278,5080,198,193
2022,地區醫院,Enterococcus faecalis,Gentamicin-High,107772,5085,2483,2602,192
2022,地區醫院,Enterococcus faecalis,Vancomycin,107772,7748,7523,225,198
2022,地區醫院,Enterococcus faecium,Ampicillin,103886,2599,191,2408,190
2022,地區醫院,Enterococcus faecium,Gentamicin-High,103886,2663,1542,1121,190
2022,地區醫院,Enterococcus faecium,Vancomycin,103886,3866,1620,2246,195
2022,地區醫院,Staphylococcus aureus,Ciprofloxacin,125752,9500,4814,4686,210
2022,地區醫院,Staphylococcus aureus,Oxacillin,125752,25437,10389,15048,221
2022,地區醫院,Staphylococcus aureus,Trimethoprim/Sulfamethoxazole,125752,20949,18313,2636,213
2022,地區醫院,Staphylococcus aureus,Vancomycin,125752,23578,23300,278,217
2022,地區醫院,Enterococcus spp.,Ampicillin,6767,2904,1842,1062,203
2022,地區醫院,Enterococcus spp.,Gentamicin-High,6767,4050,2212,1838,202
2022,地區醫院,Enterococcus spp.,Vancomycin,6767,6734,4915,1819,209
2021,醫學中心,Acinetobacter baumannii,Ampicillin/Sulbactam,16774,10276,4869,5407,19
2021,醫學中心,Acinetobacter baumannii,Amikacin,16774,7903,3325,4578,19
2021,醫學中心,Acinetobacter baumannii,Cefepime,16774,12316,4756,7560,19
2021,醫學中心,Acinetobacter baumannii,Ciprofloxacin,16774,12766,4732,8034,19
2021,醫學中心,Acinetobacter baumannii,Ceftazidime,16774,12754,4741,8013,19
2021,醫學中心,Acinetobacter baumannii,Colistin,16774,7322,4001,3321,17
2021,醫學中心,Acinetobacter baumannii,Gentamicin,16774,11160,4492,6668,19
2021,醫學中心,Acinetobacter baumannii,Imipenem,16774,15573,6170,9403,24
2021,醫學中心,Acinetobacter baumannii,Levofloxacin,16774,8298,3708,4590,17
2021,醫學中心,Acinetobacter baumannii,Meropenem,16774,10053,4018,6035,24
2021,醫學中心,Acinetobacter baumannii,Piperacillin/Tazobactam,16774,11166,3806,7360,19
2021,醫學中心,Acinetobacter baumannii,Piperacillin,16774,795,286,509,17
2021,醫學中心,Acinetobacter baumannii,Tigecycline,16774,6957,4912,2045,17
2021,醫學中心,Enterobacter cloacae,Amikacin,8035,5844,5736,108,17
2021,醫學中心,Enterobacter cloacae,Cefotaxime,8035,3771,1964,1807,17
2021,醫學中心,Enterobacter cloacae,Cefepime,8035,6563,5337,1226,17
2021,醫學中心,Enterobacter cloacae,Ciprofloxacin,8035,6294,4516,1778,17
2021,醫學中心,Enterobacter cloacae,Ceftazidime,8035,6829,3773,3056,19
2021,醫學中心,Enterobacter cloacae,Ceftriaxone,8035,4536,2401,2135,19
2021,醫學中心,Enterobacter cloacae,Ertapenem,8035,7351,6154,1197,19
2021,醫學中心,Enterobacter cloacae,Gentamicin,8035,6657,5764,893,17
2021,醫學中心,Enterobacter cloacae,Imipenem,8035,6479,5710,769,19
2021,醫學中心,Enterobacter cloacae,Levofloxacin,8035,5261,3667,1594,17
2021,醫學中心,Enterobacter cloacae,Meropenem,8035,3367,3152,215,19
2021,醫學中心,Escherichia coli,Ampicillin/Sulbactam,94216,50965,21490,29475,17
2021,醫學中心,Escherichia coli,Ampicillin,94216,14079,3776,10303,17
2021,醫學中心,Escherichia coli,Amikacin,94216,72431,71996,435,19
2021,醫學中心,Escherichia coli,Cefuroxime sodium,94216,10487,6500,3987,17
2021,醫學中心,Escherichia coli,Cefotaxime,94216,33302,22423,10879,17
2021,醫學中心,Escherichia coli,Ciprofloxacin,94216,72609,39844,32765,19
2021,醫學中心,Escherichia coli,Ceftazidime,94216,52000,39706,12294,19
2021,醫學中心,Escherichia coli,Cefazolin,94216,42038,23234,18804,17
2021,醫學中心,Escherichia coli,Ceftriaxone,94216,46233,30456,15777,19
2021,醫學中心,Escherichia coli,Ertapenem,94216,85137,83905,1232,21
2021,醫學中心,Escherichia coli,Gentamicin,94216,75878,57996,17882,19
2021,醫學中心,Escherichia coli,Imipenem,94216,73106,72342,764,21
2021,醫學中心,Escherichia coli,Levofloxacin,94216,58843,32905,25938,19
2021,醫學中心,Escherichia coli,Meropenem,94216,27433,27229,204,21
2021,醫學中心,Klebsiella pneumoniae,Ampicillin/Sulbactam,51976,26373,13587,12786,17
2021,醫學中心,Klebsiella pneumoniae,Ampicillin,51976,7561,344,7217,17
2021,醫學中心,Klebsiella pneumoniae,Amikacin,51976,33286,31672,1614,19
2021,醫學中心,Klebsiella pneumoniae,Cefuroxime sodium,51976,5632,2842,2790,17
2021,醫學中心,Klebsiella pneumoniae,Cefotaxime,51976,16358,10374,5984,17
2021,醫學中心,Klebsiella pneumoniae,Ciprofloxacin,51976,35798,21183,14615,19
2021,醫學中心,Klebsiella pneumoniae,Ceftazidime,51976,30494,18101,12393,19
2021,醫學中心,Klebsiella pneumoniae,Cefazolin,51976,24021,10606,13415,17
2021,醫學中心,Klebsiella pneumoniae,Ceftriaxone,51976,16227,9608,6619,17
2021,醫學中心,Klebsiella pneumoniae,Ertapenem,51976,47854,41440,6414,24
2021,醫學中心,Klebsiella pneumoniae,Gentamicin,51976,37178,26452,10726,19
2021,醫學中心,Klebsiella pneumoniae,Imipenem,51976,39776,33925,5851,24
2021,醫學中心,Klebsiella pneumoniae,Levofloxacin,51976,21002,12234,8768,17
2021,醫學中心,Klebsiella pneumoniae,Meropenem,51976,15250,13743,1507,24
2021,醫學中心,Proteus mirabilis,Ampicillin/Sulbactam,10944,8268,5490,2778,19
2021,醫學中心,Proteus mirabilis,Ampicillin,10944,2141,925,1216,17
2021,醫學中心,Proteus mirabilis,Amikacin,10944,8260,7972,288,17
2021,醫學中心,Proteus mirabilis,Cefuroxime sodium,10944,1348,1160,188,17
2021,醫學中心,Proteus mirabilis,Cefotaxime,10944,5101,4279,822,17
2021,醫學中心,Proteus mirabilis,Ciprofloxacin,10944,8264,5470,2794,17
2021,醫學中心,Proteus mirabilis,Cefazolin,10944,8907,3815,5092,19
2021,醫學中心,Proteus mirabilis,Ceftriaxone,10944,4210,3656,554,17
2021,醫學中心,Proteus mirabilis,Gentamicin,10944,10879,7696,3183,19
2021,醫學中心,Proteus mirabilis,Levofloxacin,10944,7245,5030,2215,17
2021,醫學中心,Proteus mirabilis,Meropenem,10944,4876,4701,175,17
2021,醫學中心,Pseudomonas aeruginosa,Amikacin,35182,23739,23215,524,17
2021,醫學中心,Pseudomonas aeruginosa,Cefepime,35182,23224,19772,3452,17
2021,醫學中心,Pseudomonas aeruginosa,Ciprofloxacin,35182,30008,24073,5935,19
2021,醫學中心,Pseudomonas aeruginosa,Ceftazidime,35182,30012,25108,4904,19
2021,醫學中心,Pseudomonas aeruginosa,Gentamicin,35182,27530,25199,2331,19
2021,醫學中心,Pseudomonas aeruginosa,Imipenem,35182,31288,25988,5300,20
2021,醫學中心,Pseudomonas aeruginosa,Levofloxacin,35182,24039,17712,6327,19
2021,醫學中心,Pseudomonas aeruginosa,Meropenem,35182,23497,20221,3276,20
2021,醫學中心,Pseudomonas aeruginosa,Piperacillin/Tazobactam,35182,29940,24153,5787,19
2021,醫學中心,Pseudomonas aeruginosa,Piperacillin,35182,3108,2547,561,17
2021,醫學中心,Enterococcus faecalis,Ampicillin,24999,14264,14214,50,19
2021,醫學中心,Enterococcus faecalis,Gentamicin-High,24999,15015,8980,6035,19
2021,醫學中心,Enterococcus faecalis,Vancomycin,24999,24923,24810,113,24
2021,醫學中心,Enterococcus faecium,Ampicillin,19700,10043,776,9267,19
2021,醫學中心,Enterococcus faecium,Gentamicin-High,19700,12168,7087,5081,19
2021,醫學中心,Enterococcus faecium,Vancomycin,19700,19612,7478,12134,24
2021,醫學中心,Staphylococcus aureus,Ciprofloxacin,42567,13239,9560,3679,17
2021,醫學中心,Staphylococcus aureus,Oxacillin,42567,42539,23430,19109,24
2021,醫學中心,Staphylococcus aureus,Trimethoprim/Sulfamethoxazole,42567,30319,27491,2828,19
2021,醫學中心,Staphylococcus aureus,Vancomycin,42567,30237,30235,2,20
2021,醫學中心,Enterococcus spp.,Ampicillin,2161,1334,927,407,19
2021,醫學中心,Enterococcus spp.,Gentamicin-High,2161,1352,1174,178,19
2021,醫學中心,Enterococcus spp.,Vancomycin,2161,2148,1474,674,23
2021,區域醫院,Acinetobacter baumannii,Ampicillin/Sulbactam,20910,16462,6104,10358,73
2021,區域醫院,Acinetobacter baumannii,Amikacin,20910,11342,4459,6883,73
2021,區域醫院,Acinetobacter baumannii,Cefepime,20910,15991,4902,11089,72
2021,區域醫院,Acinetobacter baumannii,Ciprofloxacin,20910,11893,3289,8604,72
2021,區域醫院,Acinetobacter baumannii,Ceftazidime,20910,16753,4699,12054,73
2021,區域醫院,Acinetobacter baumannii,Colistin,20910,4841,3616,1225,70
2021,區域醫院,Acinetobacter baumannii,Gentamicin,20910,16795,5135,11660,73
2021,區域醫院,Acinetobacter baumannii,Imipenem,20910,18043,5411,12632,80
2021,區域醫院,Acinetobacter baumannii,Levofloxacin,20910,12056,4064,7992,72
2021,區域醫院,Acinetobacter baumannii,Meropenem,20910,10505,3207,7298,78
2021,區域醫院,Acinetobacter baumannii,Piperacillin/Tazobactam,20910,16283,3990,12293,73
2021,區域醫院,Acinetobacter baumannii,Piperacillin,20910,2796,354,2442,69
2021,區域醫院,Acinetobacter baumannii,Tigecycline,20910,9615,6549,3066,69
2021,區域醫院,Enterobacter cloacae,Amikacin,9039,7477,7343,134,69
2021,區域醫院,Enterobacter cloacae,Cefotaxime,9039,2790,1557,1233,68
2021,區域醫院,Enterobacter cloacae,Cefepime,9039,7251,6140,1111,68
2021,區域醫院,Enterobacter cloacae,Ciprofloxacin,9039,5318,3908,1410,68
2021,區域醫院,Enterobacter cloacae,Ceftazidime,9039,7037,4412,2625,71
2021,區域醫院,Enterobacter cloacae,Ceftriaxone,9039,5838,3357,2481,71
2021,區域醫院,Enterobacter cloacae,Ertapenem,9039,7243,6081,1162,72
2021,區域醫院,Enterobacter cloacae,Gentamicin,9039,7651,6752,899,69
2021,區域醫院,Enterobacter cloacae,Imipenem,9039,5999,5273,726,71
2021,區域醫院,Enterobacter cloacae,Levofloxacin,9039,5427,4329,1098,69
2021,區域醫院,Enterobacter cloacae,Meropenem,9039,3582,3378,204,71
2021,區域醫院,Escherichia coli,Ampicillin/Sulbactam,160286,107858,50588,57270,69
2021,區域醫院,Escherichia coli,Ampicillin,160286,67957,17769,50188,69
2021,區域醫院,Escherichia coli,Amikacin,160286,131405,129617,1788,71
2021,區域醫院,Escherichia coli,Cefuroxime sodium,160286,26676,17109,9567,69
2021,區域醫院,Escherichia coli,Cefotaxime,160286,48227,32512,15715,70
2021,區域醫院,Escherichia coli,Ciprofloxacin,160286,91671,50771,40900,70
2021,區域醫院,Escherichia coli,Ceftazidime,160286,101779,76479,25300,71
2021,區域醫院,Escherichia coli,Cefazolin,160286,106657,60780,45877,69
2021,區域醫院,Escherichia coli,Ceftriaxone,160286,88294,58726,29568,71
2021,區域醫院,Escherichia coli,Ertapenem,160286,116298,112830,3468,75
2021,區域醫院,Escherichia coli,Gentamicin,160286,132994,100830,32164,71
2021,區域醫院,Escherichia coli,Imipenem,160286,98088,95423,2665,75
2021,區域醫院,Escherichia coli,Levofloxacin,160286,96032,53294,42738,71
2021,區域醫院,Escherichia coli,Meropenem,160286,58071,56028,2043,73
2021,區域醫院,Klebsiella pneumoniae,Ampicillin/Sulbactam,68796,44573,22696,21877,71
2021,區域醫院,Klebsiella pneumoniae,Ampicillin,68796,23403,503,22900,71
2021,區域醫院,Klebsiella pneumoniae,Amikacin,68796,53324,50198,3126,73
2021,區域醫院,Klebsiella pneumoniae,Cefuroxime sodium,68796,10521,5810,4711,71
2021,區域醫院,Klebsiella pneumoniae,Cefotaxime,68796,19792,11604,8188,70
2021,區域醫院,Klebsiella pneumoniae,Ciprofloxacin,68796,39224,23562,15662,72
2021,區域醫院,Klebsiella pneumoniae,Ceftazidime,68796,44090,27007,17083,73
2021,區域醫院,Klebsiella pneumoniae,Cefazolin,68796,44950,23500,21450,71
2021,區域醫院,Klebsiella pneumoniae,Ceftriaxone,68796,31366,20600,10766,71
2021,區域醫院,Klebsiella pneumoniae,Ertapenem,68796,49225,40475,8750,78
2021,區域醫院,Klebsiella pneumoniae,Gentamicin,68796,54283,38541,15742,73
2021,區域醫院,Klebsiella pneumoniae,Imipenem,68796,43896,36421,7475,80
2021,區域醫院,Klebsiella pneumoniae,Levofloxacin,68796,34514,21972,12542,71
2021,區域醫院,Klebsiella pneumoniae,Meropenem,68796,25909,22398,3511,78
2021,區域醫院,Proteus mirabilis,Ampicillin/Sulbactam,23904,18971,11042,7929,71
2021,區域醫院,Proteus mirabilis,Ampicillin,23904,10794,3732,7062,69
2021,區域醫院,Proteus mirabilis,Amikacin,23904,19772,17835,1937,69
2021,區域醫院,Proteus mirabilis,Cefuroxime sodium,23904,4352,3310,1042,69
2021,區域醫院,Proteus mirabilis,Cefotaxime,23904,8546,6385,2161,68
2021,區域醫院,Proteus mirabilis,Ciprofloxacin,23904,14455,7658,6797,68
2021,區域醫院,Proteus mirabilis,Cefazolin,23904,18821,7655,11166,71
2021,區域醫院,Proteus mirabilis,Ceftriaxone,23904,12157,9668,2489,69
2021,區域醫院,Proteus mirabilis,Gentamicin,23904,21134,12130,9004,71
2021,區域醫院,Proteus mirabilis,Levofloxacin,23904,13794,8135,5659,69
2021,區域醫院,Proteus mirabilis,Meropenem,23904,10677,10456,221,69
2021,區域醫院,Pseudomonas aeruginosa,Amikacin,48417,35245,33801,1444,69
2021,區域醫院,Pseudomonas aeruginosa,Cefepime,48417,36021,30638,5383,68
2021,區域醫院,Pseudomonas aeruginosa,Ciprofloxacin,48417,33241,25037,8204,70
2021,區域醫院,Pseudomonas aeruginosa,Ceftazidime,48417,39848,33474,6374,71
2021,區域醫院,Pseudomonas aeruginosa,Gentamicin,48417,40461,34617,5844,71
2021,區域醫院,Pseudomonas aeruginosa,Imipenem,48417,36416,30020,6396,75
2021,區域醫院,Pseudomonas aeruginosa,Levofloxacin,48417,34423,24174,10249,71
2021,區域醫院,Pseudomonas aeruginosa,Meropenem,48417,26740,22549,4191,75
2021,區域醫院,Pseudomonas aeruginosa,Piperacillin/Tazobactam,48417,38960,31861,7099,71
2021,區域醫院,Pseudomonas aeruginosa,Piperacillin,48417,5713,4224,1489,67
2021,區域醫院,Enterococcus faecalis,Ampicillin,23962,14598,14328,270,73
2021,區域醫院,Enterococcus faecalis,Gentamicin-High,23962,20185,11072,9113,73
2021,區域醫院,Enterococcus faecalis,Vancomycin,23962,24091,23775,316,80
2021,區域醫院,Enterococcus faecium,Ampicillin,16468,10690,627,10063,73
2021,區域醫院,Enterococcus faecium,Gentamicin-High,16468,14029,7510,6519,73
2021,區域醫院,Enterococcus faecium,Vancomycin,16468,16401,5158,11243,80
2021,區域醫院,Staphylococcus aureus,Ciprofloxacin,50633,11993,7389,4604,71
2021,區域醫院,Staphylococcus aureus,Oxacillin,50633,47772,23103,24669,80
2021,區域醫院,Staphylococcus aureus,Trimethoprim/Sulfamethoxazole,50633,43838,39188,4650,73
2021,區域醫院,Staphylococcus aureus,Vancomycin,50633,41235,40606,629,74
2021,區域醫院,Enterococcus spp.,Ampicillin,7615,4387,2732,1655,68
2021,區域醫院,Enterococcus spp.,Gentamicin-High,7615,5157,3271,1886,68
2021,區域醫院,Enterococcus spp.,Vancomycin,7615,6076,4484,1592,73
2021,地區醫院,Acinetobacter baumannii,Ampicillin/Sulbactam,111297,7544,2553,4991,207
2021,地區醫院,Acinetobacter baumannii,Amikacin,111297,7852,1793,6059,208
2021,地區醫院,Acinetobacter baumannii,Cefepime,111297,8372,1506,6866,208
2021,地區醫院,Acinetobacter baumannii,Ciprofloxacin,111297,7178,917,6261,208
2021,地區醫院,Acinetobacter baumannii,Ceftazidime,111297,9379,1590,7789,208
2021,地區醫院,Acinetobacter baumannii,Colistin,111297,3587,2745,842,205
2021,地區醫院,Acinetobacter baumannii,Gentamicin,111297,9137,1741,7396,208
2021,地區醫院,Acinetobacter baumannii,Imipenem,111297,8681,1976,6705,214
2021,地區醫院,Acinetobacter baumannii,Levofloxacin,111297,6412,881,5531,205
2021,地區醫院,Acinetobacter baumannii,Meropenem,111297,5738,1224,4514,213
2021,地區醫院,Acinetobacter baumannii,Piperacillin/Tazobactam,111297,8475,1134,7341,207
2021,地區醫院,Acinetobacter baumannii,Piperacillin,111297,1305,133,1172,204
2021,地區醫院,Acinetobacter baumannii,Tigecycline,111297,3863,2652,1211,204
2021,地區醫院,Enterobacter cloacae,Amikacin,2592,2294,2113,181,191
2021,地區醫院,Enterobacter cloacae,Cefotaxime,2592,1002,586,416,190
2021,地區醫院,Enterobacter cloacae,Cefepime,2592,2054,1651,403,191
2021,地區醫院,Enterobacter cloacae,Ciprofloxacin,2592,2024,1407,617,191
2021,地區醫院,Enterobacter cloacae,Ceftazidime,2592,2146,1372,774,194
2021,地區醫院,Enterobacter cloacae,Ceftriaxone,2592,1544,882,662,193
2021,地區醫院,Enterobacter cloacae,Ertapenem,2592,1931,1587,344,195
2021,地區醫院,Enterobacter cloacae,Gentamicin,2592,2409,1917,492,191
2021,地區醫院,Enterobacter cloacae,Imipenem,2592,1926,1659,267,196
2021,地區醫院,Enterobacter cloacae,Levofloxacin,2592,1747,1226,521,191
2021,地區醫院,Enterobacter cloacae,Meropenem,2592,1394,1243,151,195
2021,地區醫院,Escherichia coli,Ampicillin/Sulbactam,390650,46486,20412,26074,204
2021,地區醫院,Escherichia coli,Ampicillin,390650,37718,8660,29058,204
2021,地區醫院,Escherichia coli,Amikacin,390650,64499,61674,2825,207
2021,地區醫院,Escherichia coli,Cefuroxime sodium,390650,13253,7687,5566,202
2021,地區醫院,Escherichia coli,Cefotaxime,390650,21731,13657,8074,203
2021,地區醫院,Escherichia coli,Ciprofloxacin,390650,52614,25522,27092,207
2021,地區醫院,Escherichia coli,Ceftazidime,390650,53047,35114,17933,207
2021,地區醫院,Escherichia coli,Cefazolin,390650,52799,23527,29272,203
2021,地區醫院,Escherichia coli,Ceftriaxone,390650,46174,26155,20019,206
2021,地區醫院,Escherichia coli,Ertapenem,390650,44941,42525,2416,207
2021,地區醫院,Escherichia coli,Gentamicin,390650,64318,45802,18516,207
2021,地區醫院,Escherichia coli,Imipenem,390650,45493,43632,1861,210
2021,地區醫院,Escherichia coli,Levofloxacin,390650,41172,19243,21929,206
2021,地區醫院,Escherichia coli,Meropenem,390650,35688,34235,1453,210
2021,地區醫院,Klebsiella pneumoniae,Ampicillin/Sulbactam,133478,20976,9036,11940,208
2021,地區醫院,Klebsiella pneumoniae,Ampicillin,133478,17625,986,16639,208
2021,地區醫院,Klebsiella pneumoniae,Amikacin,133478,29054,24954,4100,211
2021,地區醫院,Klebsiella pneumoniae,Cefuroxime sodium,133478,4709,2433,2276,207
2021,地區醫院,Klebsiella pneumoniae,Cefotaxime,133478,9115,5329,3786,208
2021,地區醫院,Klebsiella pneumoniae,Ciprofloxacin,133478,23092,12543,10549,211
2021,地區醫院,Klebsiella pneumoniae,Ceftazidime,133478,25615,14318,11297,211
2021,地區醫院,Klebsiella pneumoniae,Cefazolin,133478,24449,10045,14404,207
2021,地區醫院,Klebsiella pneumoniae,Ceftriaxone,133478,21411,11876,9535,207
2021,地區醫院,Klebsiella pneumoniae,Ertapenem,133478,20103,15615,4488,216
2021,地區醫院,Klebsiella pneumoniae,Gentamicin,133478,29127,19049,10078,211
2021,地區醫院,Klebsiella pneumoniae,Imipenem,133478,24193,19262,4931,217
2021,地區醫院,Klebsiella pneumoniae,Levofloxacin,133478,18494,10500,7994,208
2021,地區醫院,Klebsiella pneumoniae,Meropenem,133478,15562,12779,2783,216
2021,地區醫院,Proteus mirabilis,Ampicillin/Sulbactam,218555,13889,6205,7684,206
2021,地區醫院,Proteus mirabilis,Ampicillin,218555,11386,1975,9411,204
2021,地區醫院,Proteus mirabilis,Amikacin,218555,17369,13370,3999,204
2021,地區醫院,Proteus mirabilis,Cefuroxime sodium,218555,2461,1496,965,202
2021,地區醫院,Proteus mirabilis,Cefotaxime,218555,5042,3173,1869,203
2021,地區醫院,Proteus mirabilis,Ciprofloxacin,218555,13707,4870,8837,204
2021,地區醫院,Proteus mirabilis,Cefazolin,218555,13666,3457,10209,205
2021,地區醫院,Proteus mirabilis,Ceftriaxone,218555,13641,9060,4581,203
2021,地區醫院,Proteus mirabilis,Gentamicin,218555,17557,6022,11535,207
2021,地區醫院,Proteus mirabilis,Levofloxacin,218555,12075,4800,7275,204
2021,地區醫院,Proteus mirabilis,Meropenem,218555,9529,9238,291,204
2021,地區醫院,Pseudomonas aeruginosa,Amikacin,27893,25947,23499,2448,204
2021,地區醫院,Pseudomonas aeruginosa,Cefepime,27893,22417,17413,5004,204
2021,地區醫院,Pseudomonas aeruginosa,Ciprofloxacin,27893,20538,11576,8962,207
2021,地區醫院,Pseudomonas aeruginosa,Ceftazidime,27893,26100,20480,5620,207
2021,地區醫院,Pseudomonas aeruginosa,Gentamicin,27893,26756,18114,8642,207
2021,地區醫院,Pseudomonas aeruginosa,Imipenem,27893,20722,14873,5849,208
2021,地區醫院,Pseudomonas aeruginosa,Levofloxacin,27893,19951,9764,10187,206
2021,地區醫院,Pseudomonas aeruginosa,Meropenem,27893,15766,11322,4444,207
2021,地區醫院,Pseudomonas aeruginosa,Piperacillin/Tazobactam,27893,24631,17627,7004,206
2021,地區醫院,Pseudomonas aeruginosa,Piperacillin,27893,4469,2948,1521,202
2021,地區醫院,Enterococcus faecalis,Ampicillin,106986,4669,4550,119,192
2021,地區醫院,Enterococcus faecalis,Gentamicin-High,106986,4549,2082,2467,191
2021,地區醫院,Enterococcus faecalis,Vancomycin,106986,6950,6774,176,196
2021,地區醫院,Enterococcus faecium,Ampicillin,125362,2274,232,2042,191
2021,地區醫院,Enterococcus faecium,Gentamicin-High,125362,2107,1193,914,190
2021,地區醫院,Enterococcus faecium,Vancomycin,125362,3349,1461,1888,195
2021,地區醫院,Staphylococcus aureus,Ciprofloxacin,24317,10064,4789,5275,207
2021,地區醫院,Staphylococcus aureus,Oxacillin,24317,23496,9516,13980,217
2021,地區醫院,Staphylococcus aureus,Trimethoprim/Sulfamethoxazole,24317,19401,16904,2497,210
2021,地區醫院,Staphylococcus aureus,Vancomycin,24317,22004,21631,373,213
2021,地區醫院,Enterococcus spp.,Ampicillin,6497,2663,1763,900,197
2021,地區醫院,Enterococcus spp.,Gentamicin-High,6497,3595,1753,1842,197
2021,地區醫院,Enterococcus spp.,Vancomycin,6497,6441,4774,1667,204
2020,醫學中心,Acinetobacter baumannii,Ampicillin/Sulbactam,17980,10513,4986,5527,18
2020,醫學中心,Acinetobacter baumannii,Amikacin,17980,8437,3744,4693,18
2020,醫學中心,Acinetobacter baumannii,Cefepime,17980,13352,5409,7943,18
2020,醫學中心,Acinetobacter baumannii,Ciprofloxacin,17980,13989,5315,8674,18
2020,醫學中心,Acinetobacter baumannii,Ceftazidime,17980,13972,5478,8494,18
2020,醫學中心,Acinetobacter baumannii,Colistin,17980,8176,7895,281,16
2020,醫學中心,Acinetobacter baumannii,Gentamicin,17980,12256,4984,7272,18
2020,醫學中心,Acinetobacter baumannii,Imipenem,17980,16509,6259,10250,23
2020,醫學中心,Acinetobacter baumannii,Levofloxacin,17980,9260,4265,4995,17
2020,醫學中心,Acinetobacter baumannii,Meropenem,17980,10805,4234,6571,23
2020,醫學中心,Acinetobacter baumannii,Piperacillin/Tazobactam,17980,12429,4276,8153,18
2020,醫學中心,Acinetobacter baumannii,Piperacillin,17980,946,244,702,16
2020,醫學中心,Acinetobacter baumannii,Tigecycline,17980,7150,5265,1885,16
2020,醫學中心,Enterobacter cloacae,Amikacin,8626,6256,6150,106,16
2020,醫學中心,Enterobacter cloacae,Cefotaxime,8626,3878,2094,1784,16
2020,醫學中心,Enterobacter cloacae,Cefepime,8626,6871,5483,1388,16
2020,醫學中心,Enterobacter cloacae,Ciprofloxacin,8626,6699,4874,1825,16
2020,醫學中心,Enterobacter cloacae,Ceftazidime,8626,7430,4110,3320,18
2020,醫學中心,Enterobacter cloacae,Ceftriaxone,8626,5019,2589,2430,18
2020,醫學中心,Enterobacter cloacae,Ertapenem,8626,7681,6408,1273,18
2020,醫學中心,Enterobacter cloacae,Gentamicin,8626,7006,6039,967,16
2020,醫學中心,Enterobacter cloacae,Imipenem,8626,6962,5994,968,18
2020,醫學中心,Enterobacter cloacae,Levofloxacin,8626,5865,4192,1673,16
2020,醫學中心,Enterobacter cloacae,Meropenem,8626,3552,3366,186,18
2020,醫學中心,Escherichia coli,Ampicillin/Sulbactam,89754,54748,22420,32328,16
2020,醫學中心,Escherichia coli,Ampicillin,89754,15851,4991,10860,16
2020,醫學中心,Escherichia coli,Amikacin,89754,81557,80558,999,18
2020,醫學中心,Escherichia coli,Cefuroxime sodium,89754,11201,6796,4405,16
2020,醫學中心,Escherichia coli,Cefotaxime,89754,36202,24079,12123,16
2020,醫學中心,Escherichia coli,Ciprofloxacin,89754,81820,45603,36217,18
2020,醫學中心,Escherichia coli,Ceftazidime,89754,59412,44362,15050,18
2020,醫學中心,Escherichia coli,Cefazolin,89754,49457,25900,23557,16
2020,醫學中心,Escherichia coli,Ceftriaxone,89754,52733,34013,18720,18
2020,醫學中心,Escherichia coli,Ertapenem,89754,80297,78850,1447,18
2020,醫學中心,Escherichia coli,Gentamicin,89754,85267,64791,20476,18
2020,醫學中心,Escherichia coli,Imipenem,89754,65557,64501,1056,18
2020,醫學中心,Escherichia coli,Levofloxacin,89754,65670,38660,27010,18
2020,醫學中心,Escherichia coli,Meropenem,89754,31324,30833,491,18
2020,醫學中心,Klebsiella pneumoniae,Ampicillin/Sulbactam,53091,26942,13854,13088,16
2020,醫學中心,Klebsiella pneumoniae,Ampicillin,53091,7132,1,7131,16
2020,醫學中心,Klebsiella pneumoniae,Amikacin,53091,37422,34953,2469,18
2020,醫學中心,Klebsiella pneumoniae,Cefuroxime sodium,53091,5673,3004,2669,16
2020,醫學中心,Klebsiella pneumoniae,Cefotaxime,53091,17382,11088,6294,16
2020,醫學中心,Klebsiella pneumoniae,Ciprofloxacin,53091,39724,24047,15677,18
2020,醫學中心,Klebsiella pneumoniae,Ceftazidime,53091,34144,20295,13849,18
2020,醫學中心,Klebsiella pneumoniae,Cefazolin,53091,26388,11519,14869,16
2020,醫學中心,Klebsiella pneumoniae,Ceftriaxone,53091,17226,10493,6733,16
2020,醫學中心,Klebsiella pneumoniae,Ertapenem,53091,48482,41006,7476,23
2020,醫學中心,Klebsiella pneumoniae,Gentamicin,53091,41057,28496,12561,18
2020,醫學中心,Klebsiella pneumoniae,Imipenem,53091,41169,34350,6819,23
2020,醫學中心,Klebsiella pneumoniae,Levofloxacin,53091,22587,14949,7638,16
2020,醫學中心,Klebsiella pneumoniae,Meropenem,53091,16773,15095,1678,23
2020,醫學中心,Proteus mirabilis,Ampicillin/Sulbactam,11859,8891,5954,2937,18
2020,醫學中心,Proteus mirabilis,Ampicillin,11859,2286,789,1497,16
2020,醫學中心,Proteus mirabilis,Amikacin,11859,8921,8645,276,16
2020,醫學中心,Proteus mirabilis,Cefuroxime sodium,11859,1366,1189,177,16
2020,醫學中心,Proteus mirabilis,Cefotaxime,11859,5386,4500,886,16
2020,醫學中心,Proteus mirabilis,Ciprofloxacin,11859,8928,5800,3128,16
2020,醫學中心,Proteus mirabilis,Cefazolin,11859,9937,4305,5632,18
2020,醫學中心,Proteus mirabilis,Ceftriaxone,11859,4850,4092,758,16
2020,醫學中心,Proteus mirabilis,Gentamicin,11859,11689,8014,3675,18
2020,醫學中心,Proteus mirabilis,Levofloxacin,11859,7721,5266,2455,16
2020,醫學中心,Proteus mirabilis,Meropenem,11859,5207,5158,49,16
2020,醫學中心,Pseudomonas aeruginosa,Amikacin,34815,24928,24369,559,16
2020,醫學中心,Pseudomonas aeruginosa,Cefepime,34815,24327,20487,3840,16
2020,醫學中心,Pseudomonas aeruginosa,Ciprofloxacin,34815,31535,25335,6200,18
2020,醫學中心,Pseudomonas aeruginosa,Ceftazidime,34815,31571,26406,5165,18
2020,醫學中心,Pseudomonas aeruginosa,Gentamicin,34815,29021,26440,2581,18
2020,醫學中心,Pseudomonas aeruginosa,Imipenem,34815,33707,27896,5811,19
2020,醫學中心,Pseudomonas aeruginosa,Levofloxacin,34815,25293,18652,6641,18
2020,醫學中心,Pseudomonas aeruginosa,Meropenem,34815,21685,18144,3541,19
2020,醫學中心,Pseudomonas aeruginosa,Piperacillin/Tazobactam,34815,31108,25090,6018,18
2020,醫學中心,Pseudomonas aeruginosa,Piperacillin,34815,3425,2769,656,16
2020,醫學中心,Enterococcus faecalis,Ampicillin,25303,15199,15130,69,19
2020,醫學中心,Enterococcus faecalis,Gentamicin-High,25303,16022,9408,6614,19
2020,醫學中心,Enterococcus faecalis,Vancomycin,25303,25220,25123,97,23
2020,醫學中心,Enterococcus faecium,Ampicillin,18797,9756,811,8945,19
2020,醫學中心,Enterococcus faecium,Gentamicin-High,18797,11903,6275,5628,19
2020,醫學中心,Enterococcus faecium,Vancomycin,18797,18726,7489,11237,23
2020,醫學中心,Staphylococcus aureus,Ciprofloxacin,44177,14856,10749,4107,17
2020,醫學中心,Staphylococcus aureus,Oxacillin,44177,43957,23290,20667,23
2020,醫學中心,Staphylococcus aureus,Trimethoprim/Sulfamethoxazole,44177,34457,31238,3219,19
2020,醫學中心,Staphylococcus aureus,Vancomycin,44177,36948,36947,1,21
2020,醫學中心,Enterococcus spp.,Ampicillin,2512,1996,1486,510,18
2020,醫學中心,Enterococcus spp.,Gentamicin-High,2512,2013,1634,379,18
2020,醫學中心,Enterococcus spp.,Vancomycin,2512,2493,1876,617,21
2020,區域醫院,Acinetobacter baumannii,Ampicillin/Sulbactam,20992,16948,6564,10384,73
2020,區域醫院,Acinetobacter baumannii,Amikacin,20992,11769,5203,6566,73
2020,區域醫院,Acinetobacter baumannii,Cefepime,20992,16484,5472,11012,72
2020,區域醫院,Acinetobacter baumannii,Ciprofloxacin,20992,13489,3769,9720,73
2020,區域醫院,Acinetobacter baumannii,Ceftazidime,20992,17846,5126,12720,73
2020,區域醫院,Acinetobacter baumannii,Colistin,20992,5277,4623,654,72
2020,區域醫院,Acinetobacter baumannii,Gentamicin,20992,17405,5763,11642,73
2020,區域醫院,Acinetobacter baumannii,Imipenem,20992,18994,6177,12817,80
2020,區域醫院,Acinetobacter baumannii,Levofloxacin,20992,12063,4117,7946,73
2020,區域醫院,Acinetobacter baumannii,Meropenem,20992,10297,3508,6789,79
2020,區域醫院,Acinetobacter baumannii,Piperacillin/Tazobactam,20992,17011,4565,12446,73
2020,區域醫院,Acinetobacter baumannii,Piperacillin,20992,3804,460,3344,71
2020,區域醫院,Acinetobacter baumannii,Tigecycline,20992,9629,6837,2792,72
2020,區域醫院,Enterobacter cloacae,Amikacin,9629,8352,8213,139,70
2020,區域醫院,Enterobacter cloacae,Cefotaxime,9629,3281,1900,1381,70
2020,區域醫院,Enterobacter cloacae,Cefepime,9629,7546,6518,1028,69
2020,區域醫院,Enterobacter cloacae,Ciprofloxacin,9629,5826,4339,1487,70
2020,區域醫院,Enterobacter cloacae,Ceftazidime,9629,7848,4753,3095,71
2020,區域醫院,Enterobacter cloacae,Ceftriaxone,9629,6773,3780,2993,71
2020,區域醫院,Enterobacter cloacae,Ertapenem,9629,8198,6917,1281,73
2020,區域醫院,Enterobacter cloacae,Gentamicin,9629,8495,7357,1138,70
2020,區域醫院,Enterobacter cloacae,Imipenem,9629,6610,5775,835,72
2020,區域醫院,Enterobacter cloacae,Levofloxacin,9629,5799,4668,1131,70
2020,區域醫院,Enterobacter cloacae,Meropenem,9629,3894,3662,232,72
2020,區域醫院,Escherichia coli,Ampicillin/Sulbactam,144566,112680,51331,61349,70
2020,區域醫院,Escherichia coli,Ampicillin,144566,70415,18704,51711,70
2020,區域醫院,Escherichia coli,Amikacin,144566,138931,137597,1334,71
2020,區域醫院,Escherichia coli,Cefuroxime sodium,144566,27824,17152,10672,70
2020,區域醫院,Escherichia coli,Cefotaxime,144566,50059,33087,16972,70
2020,區域醫院,Escherichia coli,Ciprofloxacin,144566,97882,53319,44563,71
2020,區域醫院,Escherichia coli,Ceftazidime,144566,106002,79394,26608,71
2020,區域醫院,Escherichia coli,Cefazolin,144566,113352,62481,50871,70
2020,區域醫院,Escherichia coli,Ceftriaxone,144566,98635,64901,33734,71
2020,區域醫院,Escherichia coli,Ertapenem,144566,120994,118224,2770,75
2020,區域醫院,Escherichia coli,Gentamicin,144566,139849,104535,35314,71
2020,區域醫院,Escherichia coli,Imipenem,144566,95613,94407,1206,75
2020,區域醫院,Escherichia coli,Levofloxacin,144566,98995,55282,43713,71
2020,區域醫院,Escherichia coli,Meropenem,144566,59177,58784,393,74
2020,區域醫院,Klebsiella pneumoniae,Ampicillin/Sulbactam,63287,45220,23857,21363,72
2020,區域醫院,Klebsiella pneumoniae,Ampicillin,63287,23608,572,23036,72
2020,區域醫院,Klebsiella pneumoniae,Amikacin,63287,55474,52009,3465,73
2020,區域醫院,Klebsiella pneumoniae,Cefuroxime sodium,63287,10107,5521,4586,72
2020,區域醫院,Klebsiella pneumoniae,Cefotaxime,63287,20923,12216,8707,72
2020,區域醫院,Klebsiella pneumoniae,Ciprofloxacin,63287,40741,23655,17086,73
2020,區域醫院,Klebsiella pneumoniae,Ceftazidime,63287,44738,27757,16981,73
2020,區域醫院,Klebsiella pneumoniae,Cefazolin,63287,46605,23812,22793,72
2020,區域醫院,Klebsiella pneumoniae,Ceftriaxone,63287,33481,21900,11581,72
2020,區域醫院,Klebsiella pneumoniae,Ertapenem,63287,49580,41225,8355,78
2020,區域醫院,Klebsiella pneumoniae,Gentamicin,63287,55974,39339,16635,73
2020,區域醫院,Klebsiella pneumoniae,Imipenem,63287,43495,36526,6969,80
2020,區域醫院,Klebsiella pneumoniae,Levofloxacin,63287,32807,21749,11058,72
2020,區域醫院,Klebsiella pneumoniae,Meropenem,63287,25283,22416,2867,79
2020,區域醫院,Proteus mirabilis,Ampicillin/Sulbactam,29786,18828,11163,7665,71
2020,區域醫院,Proteus mirabilis,Ampicillin,29786,10207,3807,6400,70
2020,區域醫院,Proteus mirabilis,Amikacin,29786,19850,18002,1848,70
2020,區域醫院,Proteus mirabilis,Cefuroxime sodium,29786,4626,3459,1167,70
2020,區域醫院,Proteus mirabilis,Cefotaxime,29786,8416,6199,2217,70
2020,區域醫院,Proteus mirabilis,Ciprofloxacin,29786,14712,7652,7060,70
2020,區域醫院,Proteus mirabilis,Cefazolin,29786,19309,8227,11082,71
2020,區域醫院,Proteus mirabilis,Ceftriaxone,29786,13073,10643,2430,70
2020,區域醫院,Proteus mirabilis,Gentamicin,29786,21174,12392,8782,71
2020,區域醫院,Proteus mirabilis,Levofloxacin,29786,13266,7977,5289,70
2020,區域醫院,Proteus mirabilis,Meropenem,29786,10075,9975,100,71
2020,區域醫院,Pseudomonas aeruginosa,Amikacin,45603,36228,34802,1426,70
2020,區域醫院,Pseudomonas aeruginosa,Cefepime,45603,36350,31228,5122,69
2020,區域醫院,Pseudomonas aeruginosa,Ciprofloxacin,45603,34672,26181,8491,71
2020,區域醫院,Pseudomonas aeruginosa,Ceftazidime,45603,41793,35626,6167,71
2020,區域醫院,Pseudomonas aeruginosa,Gentamicin,45603,41550,35610,5940,71
2020,區域醫院,Pseudomonas aeruginosa,Imipenem,45603,37775,31726,6049,74
2020,區域醫院,Pseudomonas aeruginosa,Levofloxacin,45603,35406,25047,10359,71
2020,區域醫院,Pseudomonas aeruginosa,Meropenem,45603,27589,23750,3839,75
2020,區域醫院,Pseudomonas aeruginosa,Piperacillin/Tazobactam,45603,41123,33780,7343,71
2020,區域醫院,Pseudomonas aeruginosa,Piperacillin,45603,6308,4717,1591,69
2020,區域醫院,Enterococcus faecalis,Ampicillin,22290,15067,14920,147,73
2020,區域醫院,Enterococcus faecalis,Gentamicin-High,22290,19484,10257,9227,73
2020,區域醫院,Enterococcus faecalis,Vancomycin,22290,23380,23125,255,80
2020,區域醫院,Enterococcus faecium,Ampicillin,15100,10635,701,9934,73
2020,區域醫院,Enterococcus faecium,Gentamicin-High,15100,13332,7203,6129,73
2020,區域醫院,Enterococcus faecium,Vancomycin,15100,15598,5747,9851,80
2020,區域醫院,Staphylococcus aureus,Ciprofloxacin,51178,14693,8857,5836,72
2020,區域醫院,Staphylococcus aureus,Oxacillin,51178,51169,23418,27751,80
2020,區域醫院,Staphylococcus aureus,Trimethoprim/Sulfamethoxazole,51178,46905,41504,5401,73
2020,區域醫院,Staphylococcus aureus,Vancomycin,51178,44501,44491,10,74
2020,區域醫院,Enterococcus spp.,Ampicillin,6363,4244,2662,1582,71
2020,區域醫院,Enterococcus spp.,Gentamicin-High,6363,5003,3122,1881,71
2020,區域醫院,Enterococcus spp.,Vancomycin,6363,6325,4828,1497,75
2020,地區醫院,Acinetobacter baumannii,Ampicillin/Sulbactam,11226,7803,2752,5051,204
2020,地區醫院,Acinetobacter baumannii,Amikacin,11226,7659,2037,5622,204
2020,地區醫院,Acinetobacter baumannii,Cefepime,11226,8240,1380,6860,204
2020,地區醫院,Acinetobacter baumannii,Ciprofloxacin,11226,6959,984,5975,204
2020,地區醫院,Acinetobacter baumannii,Ceftazidime,11226,9272,1657,7615,204
2020,地區醫院,Acinetobacter baumannii,Colistin,11226,3750,3306,444,201
2020,地區醫院,Acinetobacter baumannii,Gentamicin,11226,9243,1806,7437,205
2020,地區醫院,Acinetobacter baumannii,Imipenem,11226,9420,2180,7240,211
2020,地區醫院,Acinetobacter baumannii,Levofloxacin,11226,6997,951,6046,202
2020,地區醫院,Acinetobacter baumannii,Meropenem,11226,5664,1247,4417,210
2020,地區醫院,Acinetobacter baumannii,Piperacillin/Tazobactam,11226,8339,1148,7191,204
2020,地區醫院,Acinetobacter baumannii,Piperacillin,11226,1464,152,1312,202
2020,地區醫院,Acinetobacter baumannii,Tigecycline,11226,3778,2842,936,202
2020,地區醫院,Enterobacter cloacae,Amikacin,2692,2302,2120,182,189
2020,地區醫院,Enterobacter cloacae,Cefotaxime,2692,985,534,451,190
2020,地區醫院,Enterobacter cloacae,Cefepime,2692,2015,1567,448,189
2020,地區醫院,Enterobacter cloacae,Ciprofloxacin,2692,2064,1352,712,189
2020,地區醫院,Enterobacter cloacae,Ceftazidime,2692,2120,1295,825,192
2020,地區醫院,Enterobacter cloacae,Ceftriaxone,2692,1635,933,702,192
2020,地區醫院,Enterobacter cloacae,Ertapenem,2692,1882,1559,323,193
2020,地區醫院,Enterobacter cloacae,Gentamicin,2692,2456,1881,575,189
2020,地區醫院,Enterobacter cloacae,Imipenem,2692,1944,1692,252,193
2020,地區醫院,Enterobacter cloacae,Levofloxacin,2692,1706,1166,540,189
2020,地區醫院,Enterobacter cloacae,Meropenem,2692,1271,1163,108,193
2020,地區醫院,Escherichia coli,Ampicillin/Sulbactam,78100,46655,20074,26581,201
2020,地區醫院,Escherichia coli,Ampicillin,78100,38202,7760,30442,201
2020,地區醫院,Escherichia coli,Amikacin,78100,62641,59949,2692,204
2020,地區醫院,Escherichia coli,Cefuroxime sodium,78100,16023,8647,7376,201
2020,地區醫院,Escherichia coli,Cefotaxime,78100,21914,13435,8479,202
2020,地區醫院,Escherichia coli,Ciprofloxacin,78100,53833,25476,28357,204
2020,地區醫院,Escherichia coli,Ceftazidime,78100,53805,34902,18903,204
2020,地區醫院,Escherichia coli,Cefazolin,78100,53852,23454,30398,202
2020,地區醫院,Escherichia coli,Ceftriaxone,78100,45419,25779,19640,204
2020,地區醫院,Escherichia coli,Ertapenem,78100,46427,43546,2881,206
2020,地區醫院,Escherichia coli,Gentamicin,78100,66197,46894,19303,204
2020,地區醫院,Escherichia coli,Imipenem,78100,45349,43200,2149,207
2020,地區醫院,Escherichia coli,Levofloxacin,78100,43958,20384,23574,204
2020,地區醫院,Escherichia coli,Meropenem,78100,35533,33630,1903,207
2020,地區醫院,Klebsiella pneumoniae,Ampicillin/Sulbactam,33316,20294,8407,11887,204
2020,地區醫院,Klebsiella pneumoniae,Ampicillin,33316,17223,561,16662,204
2020,地區醫院,Klebsiella pneumoniae,Amikacin,33316,27086,22896,4190,207
2020,地區醫院,Klebsiella pneumoniae,Cefuroxime sodium,33316,6199,2807,3392,204
2020,地區醫院,Klebsiella pneumoniae,Cefotaxime,33316,8800,5068,3732,205
2020,地區醫院,Klebsiella pneumoniae,Ciprofloxacin,33316,22522,11930,10592,207
2020,地區醫院,Klebsiella pneumoniae,Ceftazidime,33316,24693,13589,11104,207
2020,地區醫院,Klebsiella pneumoniae,Cefazolin,33316,23150,9428,13722,204
2020,地區醫院,Klebsiella pneumoniae,Ceftriaxone,33316,19144,10602,8542,204
2020,地區醫院,Klebsiella pneumoniae,Ertapenem,33316,20630,15700,4930,213
2020,地區醫院,Klebsiella pneumoniae,Gentamicin,33316,28570,18103,10467,207
2020,地區醫院,Klebsiella pneumoniae,Imipenem,33316,24538,19528,5010,214
2020,地區醫院,Klebsiella pneumoniae,Levofloxacin,33316,18708,10596,8112,204
2020,地區醫院,Klebsiella pneumoniae,Meropenem,33316,15413,12685,2728,214
2020,地區醫院,Proteus mirabilis,Ampicillin/Sulbactam,18208,13251,5917,7334,201
2020,地區醫院,Proteus mirabilis,Ampicillin,18208,10452,1764,8688,199
2020,地區醫院,Proteus mirabilis,Amikacin,18208,16434,12701,3733,198
2020,地區醫院,Proteus mirabilis,Cefuroxime sodium,18208,3483,1957,1526,198
2020,地區醫院,Proteus mirabilis,Cefotaxime,18208,4940,3064,1876,198
2020,地區醫院,Proteus mirabilis,Ciprofloxacin,18208,13715,5269,8446,198
2020,地區醫院,Proteus mirabilis,Cefazolin,18208,13048,3419,9629,201
2020,地區醫院,Proteus mirabilis,Ceftriaxone,18208,12534,8324,4210,198
2020,地區醫院,Proteus mirabilis,Gentamicin,18208,17319,5959,11360,201
2020,地區醫院,Proteus mirabilis,Levofloxacin,18208,11747,4980,6767,198
2020,地區醫院,Proteus mirabilis,Meropenem,18208,9150,8735,415,199
2020,地區醫院,Pseudomonas aeruginosa,Amikacin,27272,24862,22393,2469,201
2020,地區醫院,Pseudomonas aeruginosa,Cefepime,27272,21608,16828,4780,201
2020,地區醫院,Pseudomonas aeruginosa,Ciprofloxacin,27272,20387,11266,9121,204
2020,地區醫院,Pseudomonas aeruginosa,Ceftazidime,27272,25738,20139,5599,204
2020,地區醫院,Pseudomonas aeruginosa,Gentamicin,27272,26288,17599,8689,204
2020,地區醫院,Pseudomonas aeruginosa,Imipenem,27272,20761,15180,5581,205
2020,地區醫院,Pseudomonas aeruginosa,Levofloxacin,27272,20440,10177,10263,204
2020,地區醫院,Pseudomonas aeruginosa,Meropenem,27272,16011,11898,4113,205
2020,地區醫院,Pseudomonas aeruginosa,Piperacillin/Tazobactam,27272,23891,17103,6788,204
2020,地區醫院,Pseudomonas aeruginosa,Piperacillin,27272,4941,3287,1654,203
2020,地區醫院,Enterococcus faecalis,Ampicillin,7027,4644,4492,152,190
2020,地區醫院,Enterococcus faecalis,Gentamicin-High,7027,4547,2103,2444,190
2020,地區醫院,Enterococcus faecalis,Vancomycin,7027,6976,6734,242,194
2020,地區醫院,Enterococcus faecium,Ampicillin,3348,2452,197,2255,185
2020,地區醫院,Enterococcus faecium,Gentamicin-High,3348,2338,1218,1120,185
2020,地區醫院,Enterococcus faecium,Vancomycin,3348,3336,1231,2105,189
2020,地區醫院,Staphylococcus aureus,Ciprofloxacin,25065,9547,4807,4740,205
2020,地區醫院,Staphylococcus aureus,Oxacillin,25065,24231,9636,14595,214
2020,地區醫院,Staphylococcus aureus,Trimethoprim/Sulfamethoxazole,25065,18961,16494,2467,207
2020,地區醫院,Staphylococcus aureus,Vancomycin,25065,22409,22369,40,212
2020,地區醫院,Enterococcus spp.,Ampicillin,5799,2826,1861,965,197
2020,地區醫院,Enterococcus spp.,Gentamicin-High,5799,3025,1493,1532,197
2020,地區醫院,Enterococcus spp.,Vancomycin,5799,5694,4712,982,201
2019,醫學中心,Acinetobacter baumannii,Ampicillin/Sulbactam,19767,12803,6222,6581,17
2019,醫學中心,Acinetobacter baumannii,Amikacin,19767,9110,3788,5322,17
2019,醫學中心,Acinetobacter baumannii,Cefepime,19767,14468,5699,8769,17
2019,醫學中心,Acinetobacter baumannii,Ciprofloxacin,19767,15110,5566,9544,17
2019,醫學中心,Acinetobacter baumannii,Ceftazidime,19767,15068,5841,9227,17
2019,醫學中心,Acinetobacter baumannii,Colistin,19767,8939,8811,128,15
2019,醫學中心,Acinetobacter baumannii,Gentamicin,19767,13314,5426,7888,17
2019,醫學中心,Acinetobacter baumannii,Imipenem,19767,18194,7187,11007,23
2019,醫學中心,Acinetobacter baumannii,Levofloxacin,19767,9643,4325,5318,15
2019,醫學中心,Acinetobacter baumannii,Meropenem,19767,12210,4982,7228,22
2019,醫學中心,Acinetobacter baumannii,Piperacillin/Tazobactam,19767,13582,4735,8847,17
2019,醫學中心,Acinetobacter baumannii,Piperacillin,19767,823,202,621,15
2019,醫學中心,Acinetobacter baumannii,Tigecycline,19767,7161,5278,1883,15
2019,醫學中心,Enterobacter cloacae,Amikacin,8794,5933,5821,112,15
2019,醫學中心,Enterobacter cloacae,Cefotaxime,8794,4730,2601,2129,15
2019,醫學中心,Enterobacter cloacae,Cefepime,8794,6839,5577,1262,15
2019,醫學中心,Enterobacter cloacae,Ciprofloxacin,8794,6463,5139,1324,15
2019,醫學中心,Enterobacter cloacae,Ceftazidime,8794,7187,4102,3085,17
2019,醫學中心,Enterobacter cloacae,Ceftriaxone,8794,4374,2434,1940,17
2019,醫學中心,Enterobacter cloacae,Ertapenem,8794,8025,6732,1293,17
2019,醫學中心,Enterobacter cloacae,Gentamicin,8794,6962,6022,940,15
2019,醫學中心,Enterobacter cloacae,Imipenem,8794,6665,5870,795,17
2019,醫學中心,Enterobacter cloacae,Levofloxacin,8794,5823,4679,1144,15
2019,醫學中心,Enterobacter cloacae,Meropenem,8794,3483,3381,102,17
2019,醫學中心,Escherichia coli,Ampicillin/Sulbactam,89628,50669,20632,30037,15
2019,醫學中心,Escherichia coli,Ampicillin,89628,14249,3375,10874,15
2019,醫學中心,Escherichia coli,Amikacin,89628,79805,79347,458,17
2019,醫學中心,Escherichia coli,Cefuroxime sodium,89628,12540,7130,5410,15
2019,醫學中心,Escherichia coli,Cefotaxime,89628,41431,27194,14237,15
2019,醫學中心,Escherichia coli,Ciprofloxacin,89628,80208,48141,32067,17
2019,醫學中心,Escherichia coli,Ceftazidime,89628,55399,39883,15516,17
2019,醫學中心,Escherichia coli,Cefazolin,89628,50728,26745,23983,15
2019,醫學中心,Escherichia coli,Ceftriaxone,89628,46604,30089,16515,17
2019,醫學中心,Escherichia coli,Ertapenem,89628,82526,81336,1190,19
2019,醫學中心,Escherichia coli,Gentamicin,89628,85045,64887,20158,17
2019,醫學中心,Escherichia coli,Imipenem,89628,61380,60681,699,19
2019,醫學中心,Escherichia coli,Levofloxacin,89628,72919,44138,28781,17
2019,醫學中心,Escherichia coli,Meropenem,89628,30420,30252,168,19
2019,醫學中心,Klebsiella pneumoniae,Ampicillin/Sulbactam,53243,28669,15253,13416,15
2019,醫學中心,Klebsiella pneumoniae,Ampicillin,53243,7433,0,7433,15
2019,醫學中心,Klebsiella pneumoniae,Amikacin,53243,37052,34752,2300,17
2019,醫學中心,Klebsiella pneumoniae,Cefuroxime sodium,53243,6613,3380,3233,15
2019,醫學中心,Klebsiella pneumoniae,Cefotaxime,53243,20407,13110,7297,15
2019,醫學中心,Klebsiella pneumoniae,Ciprofloxacin,53243,39507,26554,12953,17
2019,醫學中心,Klebsiella pneumoniae,Ceftazidime,53243,33272,20013,13259,17
2019,醫學中心,Klebsiella pneumoniae,Cefazolin,53243,27886,12043,15843,15
2019,醫學中心,Klebsiella pneumoniae,Ceftriaxone,53243,13333,8026,5307,15
2019,醫學中心,Klebsiella pneumoniae,Ertapenem,53243,46561,39882,6679,22
2019,醫學中心,Klebsiella pneumoniae,Gentamicin,53243,41440,29123,12317,17
2019,醫學中心,Klebsiella pneumoniae,Imipenem,53243,39206,33421,5785,23
2019,醫學中心,Klebsiella pneumoniae,Levofloxacin,53243,24369,16581,7788,15
2019,醫學中心,Klebsiella pneumoniae,Meropenem,53243,17100,15781,1319,22
2019,醫學中心,Proteus mirabilis,Ampicillin/Sulbactam,11475,9049,6192,2857,17
2019,醫學中心,Proteus mirabilis,Ampicillin,11475,2246,692,1554,15
2019,醫學中心,Proteus mirabilis,Amikacin,11475,8292,8071,221,15
2019,醫學中心,Proteus mirabilis,Cefuroxime sodium,11475,1353,1164,189,15
2019,醫學中心,Proteus mirabilis,Cefotaxime,11475,5937,4994,943,15
2019,醫學中心,Proteus mirabilis,Ciprofloxacin,11475,8310,5520,2790,15
2019,醫學中心,Proteus mirabilis,Cefazolin,11475,9966,4392,5574,17
2019,醫學中心,Proteus mirabilis,Ceftriaxone,11475,3557,3040,517,15
2019,醫學中心,Proteus mirabilis,Gentamicin,11475,11472,7837,3635,17
2019,醫學中心,Proteus mirabilis,Levofloxacin,11475,7622,5573,2049,15
2019,醫學中心,Proteus mirabilis,Meropenem,11475,5138,5060,78,15
2019,醫學中心,Pseudomonas aeruginosa,Amikacin,34168,25412,24785,627,15
2019,醫學中心,Pseudomonas aeruginosa,Cefepime,34168,24637,21140,3497,15
2019,醫學中心,Pseudomonas aeruginosa,Ciprofloxacin,34168,33051,26988,6063,17
2019,醫學中心,Pseudomonas aeruginosa,Ceftazidime,34168,33026,27842,5184,17
2019,醫學中心,Pseudomonas aeruginosa,Gentamicin,34168,30640,27751,2889,17
2019,醫學中心,Pseudomonas aeruginosa,Imipenem,34168,32942,27367,5575,17
2019,醫學中心,Pseudomonas aeruginosa,Levofloxacin,34168,28444,21665,6779,17
2019,醫學中心,Pseudomonas aeruginosa,Meropenem,34168,24277,20554,3723,17
2019,醫學中心,Pseudomonas aeruginosa,Piperacillin/Tazobactam,34168,31760,25604,6156,17
2019,醫學中心,Pseudomonas aeruginosa,Piperacillin,34168,2732,2157,575,15
2019,醫學中心,Enterococcus faecalis,Ampicillin,25204,14829,14762,67,17
2019,醫學中心,Enterococcus faecalis,Gentamicin-High,25204,15389,8731,6658,17
2019,醫學中心,Enterococcus faecalis,Vancomycin,25204,25200,24703,497,23
2019,醫學中心,Enterococcus faecium,Ampicillin,17724,9453,731,8722,17
2019,醫學中心,Enterococcus faecium,Gentamicin-High,17724,10934,5794,5140,17
2019,醫學中心,Enterococcus faecium,Vancomycin,17724,17701,7462,10239,23
2019,醫學中心,Staphylococcus aureus,Ciprofloxacin,46936,16405,11964,4441,15
2019,醫學中心,Staphylococcus aureus,Oxacillin,46936,46930,24585,22345,23
2019,醫學中心,Staphylococcus aureus,Trimethoprim/Sulfamethoxazole,46936,33460,29595,3865,17
2019,醫學中心,Staphylococcus aureus,Vancomycin,46936,35882,35859,23,19
2019,醫學中心,Enterococcus spp.,Ampicillin,2945,1930,1471,459,16
2019,醫學中心,Enterococcus spp.,Gentamicin-High,2945,2000,1573,427,16
2019,醫學中心,Enterococcus spp.,Vancomycin,2945,2943,2314,629,21
2019,區域醫院,Acinetobacter baumannii,Ampicillin/Sulbactam,21970,17459,7532,9927,75
2019,區域醫院,Acinetobacter baumannii,Amikacin,21970,11445,5593,5852,75
2019,區域醫院,Acinetobacter baumannii,Cefepime,21970,16163,5697,10466,76
2019,區域醫院,Acinetobacter baumannii,Ciprofloxacin,21970,13284,4005,9279,75
2019,區域醫院,Acinetobacter baumannii,Ceftazidime,21970,17873,5522,12351,75
2019,區域醫院,Acinetobacter baumannii,Colistin,21970,3703,3522,181,74
2019,區域醫院,Acinetobacter baumannii,Gentamicin,21970,17032,5889,11143,75
2019,區域醫院,Acinetobacter baumannii,Imipenem,21970,18868,6602,12266,82
2019,區域醫院,Acinetobacter baumannii,Levofloxacin,21970,11939,4114,7825,75
2019,區域醫院,Acinetobacter baumannii,Meropenem,21970,9819,3766,6053,81
2019,區域醫院,Acinetobacter baumannii,Piperacillin/Tazobactam,21970,16457,4716,11741,75
2019,區域醫院,Acinetobacter baumannii,Piperacillin,21970,3622,526,3096,74
2019,區域醫院,Acinetobacter baumannii,Tigecycline,21970,8850,6978,1872,74
2019,區域醫院,Enterobacter cloacae,Amikacin,9607,7883,7799,84,72
2019,區域醫院,Enterobacter cloacae,Cefotaxime,9607,3222,1959,1263,72
2019,區域醫院,Enterobacter cloacae,Cefepime,9607,6948,6096,852,72
2019,區域醫院,Enterobacter cloacae,Ciprofloxacin,9607,5356,4224,1132,72
2019,區域醫院,Enterobacter cloacae,Ceftazidime,9607,7204,4658,2546,73
2019,區域醫院,Enterobacter cloacae,Ceftriaxone,9607,6393,3868,2525,73
2019,區域醫院,Enterobacter cloacae,Ertapenem,9607,7687,6572,1115,74
2019,區域醫院,Enterobacter cloacae,Gentamicin,9607,8057,7087,970,72
2019,區域醫院,Enterobacter cloacae,Imipenem,9607,6023,5331,692,73
2019,區域醫院,Enterobacter cloacae,Levofloxacin,9607,5510,4567,943,72
2019,區域醫院,Enterobacter cloacae,Meropenem,9607,3319,3199,120,74
2019,區域醫院,Escherichia coli,Ampicillin/Sulbactam,153307,111868,50144,61724,72
2019,區域醫院,Escherichia coli,Ampicillin,153307,71032,20531,50501,72
2019,區域醫院,Escherichia coli,Amikacin,153307,136885,135346,1539,73
2019,區域醫院,Escherichia coli,Cefuroxime sodium,153307,34644,21292,13352,72
2019,區域醫院,Escherichia coli,Cefotaxime,153307,53806,35903,17903,72
2019,區域醫院,Escherichia coli,Ciprofloxacin,153307,104878,60304,44574,73
2019,區域醫院,Escherichia coli,Ceftazidime,153307,104829,78285,26544,73
2019,區域醫院,Escherichia coli,Cefazolin,153307,112153,61069,51084,72
2019,區域醫院,Escherichia coli,Ceftriaxone,153307,99381,66356,33025,73
2019,區域醫院,Escherichia coli,Ertapenem,153307,120962,119012,1950,77
2019,區域醫院,Escherichia coli,Gentamicin,153307,138550,103285,35265,73
2019,區域醫院,Escherichia coli,Imipenem,153307,95275,94300,975,77
2019,區域醫院,Escherichia coli,Levofloxacin,153307,97748,58225,39523,73
2019,區域醫院,Escherichia coli,Meropenem,153307,54136,52848,1288,76
2019,區域醫院,Klebsiella pneumoniae,Ampicillin/Sulbactam,67754,43655,23431,20224,74
2019,區域醫院,Klebsiella pneumoniae,Ampicillin,67754,22301,1139,21162,74
2019,區域醫院,Klebsiella pneumoniae,Amikacin,67754,56457,52904,3553,75
2019,區域醫院,Klebsiella pneumoniae,Cefuroxime sodium,67754,11796,6563,5233,74
2019,區域醫院,Klebsiella pneumoniae,Cefotaxime,67754,21419,12835,8584,74
2019,區域醫院,Klebsiella pneumoniae,Ciprofloxacin,67754,42760,27439,15321,75
2019,區域醫院,Klebsiella pneumoniae,Ceftazidime,67754,46324,29076,17248,75
2019,區域醫院,Klebsiella pneumoniae,Cefazolin,67754,46655,23908,22747,74
2019,區域醫院,Klebsiella pneumoniae,Ceftriaxone,67754,32480,22265,10215,74
2019,區域醫院,Klebsiella pneumoniae,Ertapenem,67754,50048,42068,7980,80
2019,區域醫院,Klebsiella pneumoniae,Gentamicin,67754,57139,40798,16341,75
2019,區域醫院,Klebsiella pneumoniae,Imipenem,67754,45761,38823,6938,82
2019,區域醫院,Klebsiella pneumoniae,Levofloxacin,67754,32636,22886,9750,74
2019,區域醫院,Klebsiella pneumoniae,Meropenem,67754,22707,20229,2478,81
2019,區域醫院,Proteus mirabilis,Ampicillin/Sulbactam,22086,18847,11548,7299,73
2019,區域醫院,Proteus mirabilis,Ampicillin,22086,10077,3623,6454,72
2019,區域醫院,Proteus mirabilis,Amikacin,22086,18924,17247,1677,72
2019,區域醫院,Proteus mirabilis,Cefuroxime sodium,22086,4871,3689,1182,72
2019,區域醫院,Proteus mirabilis,Cefotaxime,22086,7964,6001,1963,72
2019,區域醫院,Proteus mirabilis,Ciprofloxacin,22086,14264,8076,6188,72
2019,區域醫院,Proteus mirabilis,Cefazolin,22086,18956,7892,11064,73
2019,區域醫院,Proteus mirabilis,Ceftriaxone,22086,11913,9836,2077,72
2019,區域醫院,Proteus mirabilis,Gentamicin,22086,21032,12419,8613,73
2019,區域醫院,Proteus mirabilis,Levofloxacin,22086,12012,7771,4241,72
2019,區域醫院,Proteus mirabilis,Meropenem,22086,10020,9775,245,73
2019,區域醫院,Pseudomonas aeruginosa,Amikacin,47345,36819,35193,1626,72
2019,區域醫院,Pseudomonas aeruginosa,Cefepime,47345,36987,32248,4739,72
2019,區域醫院,Pseudomonas aeruginosa,Ciprofloxacin,47345,37513,28902,8611,73
2019,區域醫院,Pseudomonas aeruginosa,Ceftazidime,47345,43817,37668,6149,73
2019,區域醫院,Pseudomonas aeruginosa,Gentamicin,47345,42278,36102,6176,73
2019,區域醫院,Pseudomonas aeruginosa,Imipenem,47345,38836,33013,5823,76
2019,區域醫院,Pseudomonas aeruginosa,Levofloxacin,47345,36554,26621,9933,73
2019,區域醫院,Pseudomonas aeruginosa,Meropenem,47345,28402,24464,3938,77
2019,區域醫院,Pseudomonas aeruginosa,Piperacillin/Tazobactam,47345,41686,34454,7232,73
2019,區域醫院,Pseudomonas aeruginosa,Piperacillin,47345,8444,6561,1883,72
2019,區域醫院,Enterococcus faecalis,Ampicillin,23094,14613,14372,241,74
2019,區域醫院,Enterococcus faecalis,Gentamicin-High,23094,18898,9984,8914,74
2019,區域醫院,Enterococcus faecalis,Vancomycin,23094,22981,22521,460,81
2019,區域醫院,Enterococcus faecium,Ampicillin,14534,9767,858,8909,74
2019,區域醫院,Enterococcus faecium,Gentamicin-High,14534,12001,5815,6186,74
2019,區域醫院,Enterococcus faecium,Vancomycin,14534,14405,5466,8939,81
2019,區域醫院,Staphylococcus aureus,Ciprofloxacin,65099,16619,9841,6778,74
2019,區域醫院,Staphylococcus aureus,Oxacillin,65099,53775,24270,29505,82
2019,區域醫院,Staphylococcus aureus,Trimethoprim/Sulfamethoxazole,65099,49677,43423,6254,75
2019,區域醫院,Staphylococcus aureus,Vancomycin,65099,47281,47028,253,76
2019,區域醫院,Enterococcus spp.,Ampicillin,7685,6337,4550,1787,71
2019,區域醫院,Enterococcus spp.,Gentamicin-High,7685,6488,3955,2533,71
2019,區域醫院,Enterococcus spp.,Vancomycin,7685,7679,6119,1560,75
2019,地區醫院,Acinetobacter baumannii,Ampicillin/Sulbactam,13111,8594,2977,5617,203
2019,地區醫院,Acinetobacter baumannii,Amikacin,13111,9231,2517,6714,203
2019,地區醫院,Acinetobacter baumannii,Cefepime,13111,9577,1548,8029,201
2019,地區醫院,Acinetobacter baumannii,Ciprofloxacin,13111,8506,1113,7393,203
2019,地區醫院,Acinetobacter baumannii,Ceftazidime,13111,10867,1782,9085,203
2019,地區醫院,Acinetobacter baumannii,Colistin,13111,4306,4126,180,199
2019,地區醫院,Acinetobacter baumannii,Gentamicin,13111,10741,2003,8738,203
2019,地區醫院,Acinetobacter baumannii,Imipenem,13111,11003,2600,8403,209
2019,地區醫院,Acinetobacter baumannii,Levofloxacin,13111,8460,1057,7403,200
2019,地區醫院,Acinetobacter baumannii,Meropenem,13111,7246,1521,5725,208
2019,地區醫院,Acinetobacter baumannii,Piperacillin/Tazobactam,13111,10009,1392,8617,202
2019,地區醫院,Acinetobacter baumannii,Piperacillin,13111,1348,167,1181,198
2019,地區醫院,Acinetobacter baumannii,Tigecycline,13111,4088,3223,865,197
2019,地區醫院,Enterobacter cloacae,Amikacin,2754,2431,2265,166,190
2019,地區醫院,Enterobacter cloacae,Cefotaxime,2754,1179,667,512,190
2019,地區醫院,Enterobacter cloacae,Cefepime,2754,2049,1594,455,189
2019,地區醫院,Enterobacter cloacae,Ciprofloxacin,2754,2148,1390,758,189
2019,地區醫院,Enterobacter cloacae,Ceftazidime,2754,2253,1402,851,193
2019,地區醫院,Enterobacter cloacae,Ceftriaxone,2754,1855,1100,755,193
2019,地區醫院,Enterobacter cloacae,Ertapenem,2754,2001,1678,323,191
2019,地區醫院,Enterobacter cloacae,Gentamicin,2754,2637,2084,553,190
2019,地區醫院,Enterobacter cloacae,Imipenem,2754,2065,1861,204,193
2019,地區醫院,Enterobacter cloacae,Levofloxacin,2754,1863,1267,596,189
2019,地區醫院,Enterobacter cloacae,Meropenem,2754,1408,1307,101,192
2019,地區醫院,Escherichia coli,Ampicillin/Sulbactam,71583,46716,20242,26474,198
2019,地區醫院,Escherichia coli,Ampicillin,71583,41177,9311,31866,197
2019,地區醫院,Escherichia coli,Amikacin,71583,62972,59764,3208,202
2019,地區醫院,Escherichia coli,Cefuroxime sodium,71583,19321,10486,8835,196
2019,地區醫院,Escherichia coli,Cefotaxime,71583,26541,16126,10415,197
2019,地區醫院,Escherichia coli,Ciprofloxacin,71583,55660,27433,28227,202
2019,地區醫院,Escherichia coli,Ceftazidime,71583,55694,36242,19452,202
2019,地區醫院,Escherichia coli,Cefazolin,71583,55543,23981,31562,197
2019,地區醫院,Escherichia coli,Ceftriaxone,71583,47810,27211,20599,201
2019,地區醫院,Escherichia coli,Ertapenem,71583,44559,41855,2704,200
2019,地區醫院,Escherichia coli,Gentamicin,71583,69010,48439,20571,202
2019,地區醫院,Escherichia coli,Imipenem,71583,49326,47063,2263,203
2019,地區醫院,Escherichia coli,Levofloxacin,71583,47608,22835,24773,202
2019,地區醫院,Escherichia coli,Meropenem,71583,39312,37490,1822,202
2019,地區醫院,Klebsiella pneumoniae,Ampicillin/Sulbactam,34353,20556,8713,11843,200
2019,地區醫院,Klebsiella pneumoniae,Ampicillin,34353,18862,821,18041,199
2019,地區醫院,Klebsiella pneumoniae,Amikacin,34353,27478,23944,3534,204
2019,地區醫院,Klebsiella pneumoniae,Cefuroxime sodium,34353,8137,3863,4274,198
2019,地區醫院,Klebsiella pneumoniae,Cefotaxime,34353,10424,6110,4314,199
2019,地區醫院,Klebsiella pneumoniae,Ciprofloxacin,34353,23138,13073,10065,204
2019,地區醫院,Klebsiella pneumoniae,Ceftazidime,34353,25761,14600,11161,204
2019,地區醫院,Klebsiella pneumoniae,Cefazolin,34353,24196,10812,13384,199
2019,地區醫院,Klebsiella pneumoniae,Ceftriaxone,34353,19479,11102,8377,200
2019,地區醫院,Klebsiella pneumoniae,Ertapenem,34353,20849,16368,4481,208
2019,地區醫院,Klebsiella pneumoniae,Gentamicin,34353,30084,19811,10273,204
2019,地區醫院,Klebsiella pneumoniae,Imipenem,34353,26175,21719,4456,211
2019,地區醫院,Klebsiella pneumoniae,Levofloxacin,34353,19869,11704,8165,200
2019,地區醫院,Klebsiella pneumoniae,Meropenem,34353,15983,13296,2687,210
2019,地區醫院,Proteus mirabilis,Ampicillin/Sulbactam,18167,13408,6137,7271,199
2019,地區醫院,Proteus mirabilis,Ampicillin,18167,10867,2089,8778,197
2019,地區醫院,Proteus mirabilis,Amikacin,18167,16205,12504,3701,196
2019,地區醫院,Proteus mirabilis,Cefuroxime sodium,18167,4241,2672,1569,194
2019,地區醫院,Proteus mirabilis,Cefotaxime,18167,6194,3944,2250,194
2019,地區醫院,Proteus mirabilis,Ciprofloxacin,18167,14048,5690,8358,196
2019,地區醫院,Proteus mirabilis,Cefazolin,18167,13052,3537,9515,198
2019,地區醫院,Proteus mirabilis,Ceftriaxone,18167,12179,8053,4126,196
2019,地區醫院,Proteus mirabilis,Gentamicin,18167,17439,6191,11248,200
2019,地區醫院,Proteus mirabilis,Levofloxacin,18167,12004,5213,6791,196
2019,地區醫院,Proteus mirabilis,Meropenem,18167,9566,8991,575,195
2019,地區醫院,Pseudomonas aeruginosa,Amikacin,30109,27154,24798,2356,198
2019,地區醫院,Pseudomonas aeruginosa,Cefepime,30109,23255,18320,4935,196
2019,地區醫院,Pseudomonas aeruginosa,Ciprofloxacin,30109,23634,13223,10411,202
2019,地區醫院,Pseudomonas aeruginosa,Ceftazidime,30109,28544,22485,6059,202
2019,地區醫院,Pseudomonas aeruginosa,Gentamicin,30109,29002,19767,9235,202
2019,地區醫院,Pseudomonas aeruginosa,Imipenem,30109,23461,17738,5723,203
2019,地區醫院,Pseudomonas aeruginosa,Levofloxacin,30109,23259,11626,11633,201
2019,地區醫院,Pseudomonas aeruginosa,Meropenem,30109,18716,14085,4631,202
2019,地區醫院,Pseudomonas aeruginosa,Piperacillin/Tazobactam,30109,25400,18407,6993,201
2019,地區醫院,Pseudomonas aeruginosa,Piperacillin,30109,6284,4348,1936,199
2019,地區醫院,Enterococcus faecalis,Ampicillin,6944,4806,4641,165,187
2019,地區醫院,Enterococcus faecalis,Gentamicin-High,6944,4625,2023,2602,188
2019,地區醫院,Enterococcus faecalis,Vancomycin,6944,6896,6742,154,192
2019,地區醫院,Enterococcus faecium,Ampicillin,2916,2138,148,1990,185
2019,地區醫院,Enterococcus faecium,Gentamicin-High,2916,2139,1028,1111,184
2019,地區醫院,Enterococcus faecium,Vancomycin,2916,2889,1186,1703,190
2019,地區醫院,Staphylococcus aureus,Ciprofloxacin,26353,10651,5456,5195,204
2019,地區醫院,Staphylococcus aureus,Oxacillin,26353,25488,10109,15379,212
2019,地區醫院,Staphylococcus aureus,Trimethoprim/Sulfamethoxazole,26353,21001,18092,2909,207
2019,地區醫院,Staphylococcus aureus,Vancomycin,26353,23832,23639,193,209
2019,地區醫院,Enterococcus spp.,Ampicillin,6312,3143,2058,1085,201
2019,地區醫院,Enterococcus spp.,Gentamicin-High,6312,3800,1911,1889,201
2019,地區醫院,Enterococcus spp.,Vancomycin,6312,6286,4986,1300,206
2018,醫學中心,Acinetobacter baumannii,Ampicillin/Sulbactam,19431,11480,5764,5716,17
2018,醫學中心,Acinetobacter baumannii,Amikacin,19431,7976,3273,4703,17
2018,醫學中心,Acinetobacter baumannii,Cefepime,19431,14261,5990,8271,17
2018,醫學中心,Acinetobacter baumannii,Ciprofloxacin,19431,14945,5914,9031,17
2018,醫學中心,Acinetobacter baumannii,Ceftazidime,19431,14930,5980,8950,17
2018,醫學中心,Acinetobacter baumannii,Colistin,19431,7678,7546,132,15
2018,醫學中心,Acinetobacter baumannii,Gentamicin,19431,12513,5206,7307,17
2018,醫學中心,Acinetobacter baumannii,Imipenem,19431,17667,7578,10089,23
2018,醫學中心,Acinetobacter baumannii,Levofloxacin,19431,10226,4605,5621,15
2018,醫學中心,Acinetobacter baumannii,Meropenem,19431,12577,5557,7020,22
2018,醫學中心,Acinetobacter baumannii,Piperacillin/Tazobactam,19431,14520,5255,9265,17
2018,醫學中心,Acinetobacter baumannii,Piperacillin,19431,940,267,673,15
2018,醫學中心,Acinetobacter baumannii,Tigecycline,19431,6898,5100,1798,15
2018,醫學中心,Enterobacter cloacae,Amikacin,8317,5590,5421,169,15
2018,醫學中心,Enterobacter cloacae,Cefotaxime,8317,3502,1901,1601,15
2018,醫學中心,Enterobacter cloacae,Cefepime,8317,6386,5208,1178,15
2018,醫學中心,Enterobacter cloacae,Ciprofloxacin,8317,6142,4811,1331,15
2018,醫學中心,Enterobacter cloacae,Ceftazidime,8317,6425,3676,2749,17
2018,醫學中心,Enterobacter cloacae,Ceftriaxone,8317,4794,2681,2113,17
2018,醫學中心,Enterobacter cloacae,Ertapenem,8317,7173,5881,1292,17
2018,醫學中心,Enterobacter cloacae,Gentamicin,8317,6583,5586,997,15
2018,醫學中心,Enterobacter cloacae,Imipenem,8317,6201,5401,800,17
2018,醫學中心,Enterobacter cloacae,Levofloxacin,8317,5242,4185,1057,15
2018,醫學中心,Enterobacter cloacae,Meropenem,8317,2761,2620,141,17
2018,醫學中心,Escherichia coli,Ampicillin/Sulbactam,83071,53360,21929,31431,15
2018,醫學中心,Escherichia coli,Ampicillin,83071,17573,4267,13306,15
2018,醫學中心,Escherichia coli,Amikacin,83071,78268,77650,618,17
2018,醫學中心,Escherichia coli,Cefuroxime sodium,83071,14276,8602,5674,15
2018,醫學中心,Escherichia coli,Cefotaxime,83071,28585,19196,9389,15
2018,醫學中心,Escherichia coli,Ciprofloxacin,83071,78760,47925,30835,17
2018,醫學中心,Escherichia coli,Ceftazidime,83071,44541,32004,12537,17
2018,醫學中心,Escherichia coli,Cefazolin,83071,46757,23649,23108,15
2018,醫學中心,Escherichia coli,Ceftriaxone,83071,48644,31359,17285,17
2018,醫學中心,Escherichia coli,Ertapenem,83071,69269,68244,1025,17
2018,醫學中心,Escherichia coli,Gentamicin,83071,80951,61374,19577,17
2018,醫學中心,Escherichia coli,Imipenem,83071,54105,53434,671,17
2018,醫學中心,Escherichia coli,Levofloxacin,83071,69151,42955,26196,17
2018,醫學中心,Escherichia coli,Meropenem,83071,21884,21704,180,17
2018,醫學中心,Klebsiella pneumoniae,Ampicillin/Sulbactam,53164,27422,15096,12326,15
2018,醫學中心,Klebsiella pneumoniae,Ampicillin,53164,10220,2,10218,15
2018,醫學中心,Klebsiella pneumoniae,Amikacin,53164,35695,32824,2871,17
2018,醫學中心,Klebsiella pneumoniae,Cefuroxime sodium,53164,7446,4194,3252,15
2018,醫學中心,Klebsiella pneumoniae,Cefotaxime,53164,16936,11324,5612,15
2018,醫學中心,Klebsiella pneumoniae,Ciprofloxacin,53164,38166,26570,11596,17
2018,醫學中心,Klebsiella pneumoniae,Ceftazidime,53164,28675,17721,10954,17
2018,醫學中心,Klebsiella pneumoniae,Cefazolin,53164,25438,12177,13261,15
2018,醫學中心,Klebsiella pneumoniae,Ceftriaxone,53164,14091,9327,4764,15
2018,醫學中心,Klebsiella pneumoniae,Ertapenem,53164,43263,36976,6287,22
2018,醫學中心,Klebsiella pneumoniae,Gentamicin,53164,39524,27805,11719,17
2018,醫學中心,Klebsiella pneumoniae,Imipenem,53164,39242,33865,5377,23
2018,醫學中心,Klebsiella pneumoniae,Levofloxacin,53164,23728,17174,6554,15
2018,醫學中心,Klebsiella pneumoniae,Meropenem,53164,13916,12720,1196,22
2018,醫學中心,Proteus mirabilis,Ampicillin/Sulbactam,10921,8598,5832,2766,17
2018,醫學中心,Proteus mirabilis,Ampicillin,10921,2963,1102,1861,15
2018,醫學中心,Proteus mirabilis,Amikacin,10921,8006,7687,319,15
2018,醫學中心,Proteus mirabilis,Cefuroxime sodium,10921,1704,1509,195,15
2018,醫學中心,Proteus mirabilis,Cefotaxime,10921,4454,3893,561,15
2018,醫學中心,Proteus mirabilis,Ciprofloxacin,10921,7920,5362,2558,15
2018,醫學中心,Proteus mirabilis,Cefazolin,10921,9076,3740,5336,17
2018,醫學中心,Proteus mirabilis,Ceftriaxone,10921,3858,3323,535,15
2018,醫學中心,Proteus mirabilis,Gentamicin,10921,10716,7421,3295,17
2018,醫學中心,Proteus mirabilis,Levofloxacin,10921,6420,4775,1645,15
2018,醫學中心,Proteus mirabilis,Meropenem,10921,4060,4044,16,15
2018,醫學中心,Pseudomonas aeruginosa,Amikacin,35502,24285,23618,667,15
2018,醫學中心,Pseudomonas aeruginosa,Cefepime,35502,23241,20181,3060,15
2018,醫學中心,Pseudomonas aeruginosa,Ciprofloxacin,35502,31889,25902,5987,17
2018,醫學中心,Pseudomonas aeruginosa,Ceftazidime,35502,30988,26132,4856,17
2018,醫學中心,Pseudomonas aeruginosa,Gentamicin,35502,28786,26047,2739,17
2018,醫學中心,Pseudomonas aeruginosa,Imipenem,35502,30779,25177,5602,18
2018,醫學中心,Pseudomonas aeruginosa,Levofloxacin,35502,26507,20298,6209,17
2018,醫學中心,Pseudomonas aeruginosa,Meropenem,35502,26489,22751,3738,18
2018,醫學中心,Pseudomonas aeruginosa,Piperacillin/Tazobactam,35502,31093,25276,5817,17
2018,醫學中心,Pseudomonas aeruginosa,Piperacillin,35502,2518,2020,498,15
2018,醫學中心,Enterococcus faecalis,Ampicillin,24390,13806,13740,66,17
2018,醫學中心,Enterococcus faecalis,Gentamicin-High,24390,15656,8749,6907,17
2018,醫學中心,Enterococcus faecalis,Vancomycin,24390,24325,24168,157,23
2018,醫學中心,Enterococcus faecium,Ampicillin,16851,9226,1257,7969,17
2018,醫學中心,Enterococcus faecium,Gentamicin-High,16851,10480,5193,5287,17
2018,醫學中心,Enterococcus faecium,Vancomycin,16851,16827,7297,9530,23
2018,醫學中心,Staphylococcus aureus,Ciprofloxacin,46746,16388,11724,4664,15
2018,醫學中心,Staphylococcus aureus,Oxacillin,46746,46704,24090,22614,23
2018,醫學中心,Staphylococcus aureus,Trimethoprim/Sulfamethoxazole,46746,33557,29384,4173,17
2018,醫學中心,Staphylococcus aureus,Vancomycin,46746,35824,35801,23,19
2018,醫學中心,Enterococcus spp.,Ampicillin,2488,1829,1340,489,17
2018,醫學中心,Enterococcus spp.,Gentamicin-High,2488,2068,1506,562,17
2018,醫學中心,Enterococcus spp.,Vancomycin,2488,2458,1971,487,22
2018,區域醫院,Acinetobacter baumannii,Ampicillin/Sulbactam,24254,19811,8254,11557,74
2018,區域醫院,Acinetobacter baumannii,Amikacin,24254,14204,6275,7929,74
2018,區域醫院,Acinetobacter baumannii,Cefepime,24254,18469,6392,12077,73
2018,區域醫院,Acinetobacter baumannii,Ciprofloxacin,24254,13936,4149,9787,74
2018,區域醫院,Acinetobacter baumannii,Ceftazidime,24254,19875,5891,13984,74
2018,區域醫院,Acinetobacter baumannii,Colistin,24254,5637,5419,218,74
2018,區域醫院,Acinetobacter baumannii,Gentamicin,24254,19229,6324,12905,74
2018,區域醫院,Acinetobacter baumannii,Imipenem,24254,20275,7072,13203,80
2018,區域醫院,Acinetobacter baumannii,Levofloxacin,24254,13850,4267,9583,74
2018,區域醫院,Acinetobacter baumannii,Meropenem,24254,11057,4006,7051,80
2018,區域醫院,Acinetobacter baumannii,Piperacillin/Tazobactam,24254,18944,5448,13496,74
2018,區域醫院,Acinetobacter baumannii,Piperacillin,24254,3667,546,3121,73
2018,區域醫院,Acinetobacter baumannii,Tigecycline,24254,11059,7939,3120,73
2018,區域醫院,Enterobacter cloacae,Amikacin,9481,7894,7685,209,72
2018,區域醫院,Enterobacter cloacae,Cefotaxime,9481,3574,2106,1468,72
2018,區域醫院,Enterobacter cloacae,Cefepime,9481,7096,6136,960,71
2018,區域醫院,Enterobacter cloacae,Ciprofloxacin,9481,5250,4194,1056,72
2018,區域醫院,Enterobacter cloacae,Ceftazidime,9481,7027,4553,2474,72
2018,區域醫院,Enterobacter cloacae,Ceftriaxone,9481,6109,3812,2297,72
2018,區域醫院,Enterobacter cloacae,Ertapenem,9481,7535,6569,966,73
2018,區域醫院,Enterobacter cloacae,Gentamicin,9481,8097,7109,988,72
2018,區域醫院,Enterobacter cloacae,Imipenem,9481,6059,5394,665,72
2018,區域醫院,Enterobacter cloacae,Levofloxacin,9481,5546,4792,754,72
2018,區域醫院,Enterobacter cloacae,Meropenem,9481,3591,3498,93,73
2018,區域醫院,Escherichia coli,Ampicillin/Sulbactam,150068,110615,48056,62559,72
2018,區域醫院,Escherichia coli,Ampicillin,150068,66924,16099,50825,72
2018,區域醫院,Escherichia coli,Amikacin,150068,135752,133561,2191,72
2018,區域醫院,Escherichia coli,Cefuroxime sodium,150068,41082,25512,15570,72
2018,區域醫院,Escherichia coli,Cefotaxime,150068,57318,36462,20856,72
2018,區域醫院,Escherichia coli,Ciprofloxacin,150068,101127,59796,41331,72
2018,區域醫院,Escherichia coli,Ceftazidime,150068,103884,77435,26449,72
2018,區域醫院,Escherichia coli,Cefazolin,150068,114632,61599,53033,72
2018,區域醫院,Escherichia coli,Ceftriaxone,150068,97457,64858,32599,72
2018,區域醫院,Escherichia coli,Ertapenem,150068,118428,115620,2808,76
2018,區域醫院,Escherichia coli,Gentamicin,150068,137597,101827,35770,72
2018,區域醫院,Escherichia coli,Imipenem,150068,90422,89434,988,75
2018,區域醫院,Escherichia coli,Levofloxacin,150068,105191,64716,40475,72
2018,區域醫院,Escherichia coli,Meropenem,150068,55578,55181,397,74
2018,區域醫院,Klebsiella pneumoniae,Ampicillin/Sulbactam,67630,45783,24990,20793,74
2018,區域醫院,Klebsiella pneumoniae,Ampicillin,67630,25058,303,24755,74
2018,區域醫院,Klebsiella pneumoniae,Amikacin,67630,56773,53135,3638,74
2018,區域醫院,Klebsiella pneumoniae,Cefuroxime sodium,67630,14969,9187,5782,74
2018,區域醫院,Klebsiella pneumoniae,Cefotaxime,67630,23908,14520,9388,74
2018,區域醫院,Klebsiella pneumoniae,Ciprofloxacin,67630,42284,28780,13504,74
2018,區域醫院,Klebsiella pneumoniae,Ceftazidime,67630,45873,29398,16475,74
2018,區域醫院,Klebsiella pneumoniae,Cefazolin,67630,49160,26352,22808,74
2018,區域醫院,Klebsiella pneumoniae,Ceftriaxone,67630,33119,23399,9720,74
2018,區域醫院,Klebsiella pneumoniae,Ertapenem,67630,49440,42350,7090,79
2018,區域醫院,Klebsiella pneumoniae,Gentamicin,67630,57980,41569,16411,74
2018,區域醫院,Klebsiella pneumoniae,Imipenem,67630,43836,38424,5412,80
2018,區域醫院,Klebsiella pneumoniae,Levofloxacin,67630,38265,28233,10032,74
2018,區域醫院,Klebsiella pneumoniae,Meropenem,67630,27413,24796,2617,80
2018,區域醫院,Proteus mirabilis,Ampicillin/Sulbactam,22483,19127,11437,7690,72
2018,區域醫院,Proteus mirabilis,Ampicillin,22483,10052,3796,6256,72
2018,區域醫院,Proteus mirabilis,Amikacin,22483,19206,17333,1873,72
2018,區域醫院,Proteus mirabilis,Cefuroxime sodium,22483,5804,4553,1251,72
2018,區域醫院,Proteus mirabilis,Cefotaxime,22483,9299,6865,2434,72
2018,區域醫院,Proteus mirabilis,Ciprofloxacin,22483,14316,8377,5939,72
2018,區域醫院,Proteus mirabilis,Cefazolin,22483,19756,8057,11699,72
2018,區域醫院,Proteus mirabilis,Ceftriaxone,22483,11794,9749,2045,72
2018,區域醫院,Proteus mirabilis,Gentamicin,22483,21477,12592,8885,72
2018,區域醫院,Proteus mirabilis,Levofloxacin,22483,11868,8145,3723,72
2018,區域醫院,Proteus mirabilis,Meropenem,22483,9890,9569,321,73
2018,區域醫院,Pseudomonas aeruginosa,Amikacin,51953,39243,37473,1770,72
2018,區域醫院,Pseudomonas aeruginosa,Cefepime,51953,37086,32437,4649,71
2018,區域醫院,Pseudomonas aeruginosa,Ciprofloxacin,51953,39351,29780,9571,72
2018,區域醫院,Pseudomonas aeruginosa,Ceftazidime,51953,46406,39722,6684,72
2018,區域醫院,Pseudomonas aeruginosa,Gentamicin,51953,45259,37968,7291,72
2018,區域醫院,Pseudomonas aeruginosa,Imipenem,51953,39746,33965,5781,74
2018,區域醫院,Pseudomonas aeruginosa,Levofloxacin,51953,39314,28377,10937,72
2018,區域醫院,Pseudomonas aeruginosa,Meropenem,51953,30469,26331,4138,76
2018,區域醫院,Pseudomonas aeruginosa,Piperacillin/Tazobactam,51953,44049,36194,7855,72
2018,區域醫院,Pseudomonas aeruginosa,Piperacillin,51953,9064,7135,1929,71
2018,區域醫院,Enterococcus faecalis,Ampicillin,22809,15040,14763,277,73
2018,區域醫院,Enterococcus faecalis,Gentamicin-High,22809,18844,9854,8990,73
2018,區域醫院,Enterococcus faecalis,Vancomycin,22809,22149,21882,267,80
2018,區域醫院,Enterococcus faecium,Ampicillin,13540,9807,870,8937,73
2018,區域醫院,Enterococcus faecium,Gentamicin-High,13540,11417,5144,6273,73
2018,區域醫院,Enterococcus faecium,Vancomycin,13540,13442,5534,7908,80
2018,區域醫院,Staphylococcus aureus,Ciprofloxacin,56515,16808,10033,6775,74
2018,區域醫院,Staphylococcus aureus,Oxacillin,56515,54461,24757,29704,81
2018,區域醫院,Staphylococcus aureus,Trimethoprim/Sulfamethoxazole,56515,50108,43215,6893,74
2018,區域醫院,Staphylococcus aureus,Vancomycin,56515,47858,47466,392,75
2018,區域醫院,Enterococcus spp.,Ampicillin,8504,6608,4852,1756,70
2018,區域醫院,Enterococcus spp.,Gentamicin-High,8504,6510,3952,2558,70
2018,區域醫院,Enterococcus spp.,Vancomycin,8504,8491,7045,1446,74
2018,地區醫院,Acinetobacter baumannii,Ampicillin/Sulbactam,12546,8593,3096,5497,195
2018,地區醫院,Acinetobacter baumannii,Amikacin,12546,8103,2546,5557,195
2018,地區醫院,Acinetobacter baumannii,Cefepime,12546,8333,1464,6869,192
2018,地區醫院,Acinetobacter baumannii,Ciprofloxacin,12546,7923,1179,6744,194
2018,地區醫院,Acinetobacter baumannii,Ceftazidime,12546,9911,1825,8086,195
2018,地區醫院,Acinetobacter baumannii,Colistin,12546,3258,3064,194,190
2018,地區醫院,Acinetobacter baumannii,Gentamicin,12546,9545,1963,7582,195
2018,地區醫院,Acinetobacter baumannii,Imipenem,12546,10133,2584,7549,202
2018,地區醫院,Acinetobacter baumannii,Levofloxacin,12546,7919,1143,6776,192
2018,地區醫院,Acinetobacter baumannii,Meropenem,12546,6920,1753,5167,201
2018,地區醫院,Acinetobacter baumannii,Piperacillin/Tazobactam,12546,8933,1403,7530,194
2018,地區醫院,Acinetobacter baumannii,Piperacillin,12546,1544,214,1330,188
2018,地區醫院,Acinetobacter baumannii,Tigecycline,12546,4103,3164,939,188
2018,地區醫院,Enterobacter cloacae,Amikacin,2994,2519,2355,164,182
2018,地區醫院,Enterobacter cloacae,Cefotaxime,2994,1169,677,492,182
2018,地區醫院,Enterobacter cloacae,Cefepime,2994,2149,1671,478,181
2018,地區醫院,Enterobacter cloacae,Ciprofloxacin,2994,2200,1470,730,182
2018,地區醫院,Enterobacter cloacae,Ceftazidime,2994,2467,1610,857,184
2018,地區醫院,Enterobacter cloacae,Ceftriaxone,2994,2041,1223,818,185
2018,地區醫院,Enterobacter cloacae,Ertapenem,2994,2174,1904,270,184
2018,地區醫院,Enterobacter cloacae,Gentamicin,2994,2846,2257,589,182
2018,地區醫院,Enterobacter cloacae,Imipenem,2994,2198,2017,181,185
2018,地區醫院,Enterobacter cloacae,Levofloxacin,2994,1989,1387,602,182
2018,地區醫院,Enterobacter cloacae,Meropenem,2994,1574,1492,82,183
2018,地區醫院,Escherichia coli,Ampicillin/Sulbactam,89663,39709,16390,23319,186
2018,地區醫院,Escherichia coli,Ampicillin,89663,32852,7589,25263,186
2018,地區醫院,Escherichia coli,Amikacin,89663,53465,51276,2189,191
2018,地區醫院,Escherichia coli,Cefuroxime sodium,89663,18177,10263,7914,183
2018,地區醫院,Escherichia coli,Cefotaxime,89663,21196,13043,8153,186
2018,地區醫院,Escherichia coli,Ciprofloxacin,89663,49658,25108,24550,191
2018,地區醫院,Escherichia coli,Ceftazidime,89663,49284,32777,16507,190
2018,地區醫院,Escherichia coli,Cefazolin,89663,49230,21120,28110,186
2018,地區醫院,Escherichia coli,Ceftriaxone,89663,42387,24682,17705,189
2018,地區醫院,Escherichia coli,Ertapenem,89663,41282,38313,2969,187
2018,地區醫院,Escherichia coli,Gentamicin,89663,61388,42949,18439,191
2018,地區醫院,Escherichia coli,Imipenem,89663,41695,39385,2310,192
2018,地區醫院,Escherichia coli,Levofloxacin,89663,41238,20648,20590,190
2018,地區醫院,Escherichia coli,Meropenem,89663,34744,32012,2732,190
2018,地區醫院,Klebsiella pneumoniae,Ampicillin/Sulbactam,30957,17199,7331,9868,188
2018,地區醫院,Klebsiella pneumoniae,Ampicillin,30957,16037,568,15469,188
2018,地區醫院,Klebsiella pneumoniae,Amikacin,30957,23229,20314,2915,193
2018,地區醫院,Klebsiella pneumoniae,Cefuroxime sodium,30957,7679,3910,3769,185
2018,地區醫院,Klebsiella pneumoniae,Cefotaxime,30957,9081,5331,3750,188
2018,地區醫院,Klebsiella pneumoniae,Ciprofloxacin,30957,21376,12452,8924,193
2018,地區醫院,Klebsiella pneumoniae,Ceftazidime,30957,22416,13232,9184,193
2018,地區醫院,Klebsiella pneumoniae,Cefazolin,30957,22190,9564,12626,188
2018,地區醫院,Klebsiella pneumoniae,Ceftriaxone,30957,17707,10370,7337,188
2018,地區醫院,Klebsiella pneumoniae,Ertapenem,30957,20060,15762,4298,197
2018,地區醫院,Klebsiella pneumoniae,Gentamicin,30957,26501,17754,8747,193
2018,地區醫院,Klebsiella pneumoniae,Imipenem,30957,22473,18630,3843,201
2018,地區醫院,Klebsiella pneumoniae,Levofloxacin,30957,16711,9965,6746,188
2018,地區醫院,Klebsiella pneumoniae,Meropenem,30957,15003,11962,3041,199
2018,地區醫院,Proteus mirabilis,Ampicillin/Sulbactam,15367,10906,4710,6196,187
2018,地區醫院,Proteus mirabilis,Ampicillin,15367,8945,1856,7089,186
2018,地區醫院,Proteus mirabilis,Amikacin,15367,13303,10032,3271,185
2018,地區醫院,Proteus mirabilis,Cefuroxime sodium,15367,4088,2561,1527,181
2018,地區醫院,Proteus mirabilis,Cefotaxime,15367,5322,3449,1873,183
2018,地區醫院,Proteus mirabilis,Ciprofloxacin,15367,12124,5343,6781,185
2018,地區醫院,Proteus mirabilis,Cefazolin,15367,11831,3042,8789,187
2018,地區醫院,Proteus mirabilis,Ceftriaxone,15367,10767,7130,3637,184
2018,地區醫院,Proteus mirabilis,Gentamicin,15367,14712,5438,9274,189
2018,地區醫院,Proteus mirabilis,Levofloxacin,15367,10143,4601,5542,183
2018,地區醫院,Proteus mirabilis,Meropenem,15367,9014,8183,831,183
2018,地區醫院,Pseudomonas aeruginosa,Amikacin,26664,23599,21660,1939,186
2018,地區醫院,Pseudomonas aeruginosa,Cefepime,26664,19802,15910,3892,182
2018,地區醫院,Pseudomonas aeruginosa,Ciprofloxacin,26664,21593,11819,9774,189
2018,地區醫院,Pseudomonas aeruginosa,Ceftazidime,26664,25370,20085,5285,189
2018,地區醫院,Pseudomonas aeruginosa,Gentamicin,26664,25410,17349,8061,189
2018,地區醫院,Pseudomonas aeruginosa,Imipenem,26664,20390,15395,4995,189
2018,地區醫院,Pseudomonas aeruginosa,Levofloxacin,26664,21098,10402,10696,188
2018,地區醫院,Pseudomonas aeruginosa,Meropenem,26664,16794,12845,3949,188
2018,地區醫院,Pseudomonas aeruginosa,Piperacillin/Tazobactam,26664,23329,17280,6049,188
2018,地區醫院,Pseudomonas aeruginosa,Piperacillin,26664,6299,4229,2070,184
2018,地區醫院,Enterococcus faecalis,Ampicillin,5741,4134,3951,183,178
2018,地區醫院,Enterococcus faecalis,Gentamicin-High,5741,4262,1880,2382,177
2018,地區醫院,Enterococcus faecalis,Vancomycin,5741,5697,5488,209,182
2018,地區醫院,Enterococcus faecium,Ampicillin,2572,1949,150,1799,178
2018,地區醫院,Enterococcus faecium,Gentamicin-High,2572,2018,935,1083,177
2018,地區醫院,Enterococcus faecium,Vancomycin,2572,2547,1081,1466,182
2018,地區醫院,Staphylococcus aureus,Ciprofloxacin,24817,9210,4857,4353,192
2018,地區醫院,Staphylococcus aureus,Oxacillin,24817,23873,9597,14276,203
2018,地區醫院,Staphylococcus aureus,Trimethoprim/Sulfamethoxazole,24817,18965,16114,2851,196
2018,地區醫院,Staphylococcus aureus,Vancomycin,24817,22146,21805,341,201
2018,地區醫院,Enterococcus spp.,Ampicillin,6652,3543,2583,960,188
2018,地區醫院,Enterococcus spp.,Gentamicin-High,6652,3599,1660,1939,188
2018,地區醫院,Enterococcus spp.,Vancomycin,6652,6582,5521,1061,197
2017,醫學中心,Acinetobacter baumannii,Ampicillin/Sulbactam,18881,10563,5625,4938,17
2017,醫學中心,Acinetobacter baumannii,Amikacin,18881,8999,4367,4632,17
2017,醫學中心,Acinetobacter baumannii,Cefepime,18881,12451,5453,6998,17
2017,醫學中心,Acinetobacter baumannii,Ciprofloxacin,18881,14076,5564,8512,17
2017,醫學中心,Acinetobacter baumannii,Ceftazidime,18881,13193,5559,7634,17
2017,醫學中心,Acinetobacter baumannii,Colistin,18881,8000,7867,133,15
2017,醫學中心,Acinetobacter baumannii,Gentamicin,18881,11004,4626,6378,17
2017,醫學中心,Acinetobacter baumannii,Imipenem,18881,16551,7621,8930,23
2017,醫學中心,Acinetobacter baumannii,Levofloxacin,18881,9271,3983,5288,16
2017,醫學中心,Acinetobacter baumannii,Meropenem,18881,12458,5484,6974,22
2017,醫學中心,Acinetobacter baumannii,Piperacillin/Tazobactam,18881,13588,5216,8372,17
2017,醫學中心,Acinetobacter baumannii,Piperacillin,18881,943,304,639,15
2017,醫學中心,Acinetobacter baumannii,Tigecycline,18881,5966,4595,1371,15
2017,醫學中心,Enterobacter cloacae,Amikacin,7615,5788,5684,104,15
2017,醫學中心,Enterobacter cloacae,Cefotaxime,7615,3164,1803,1361,16
2017,醫學中心,Enterobacter cloacae,Cefepime,7615,5679,4749,930,15
2017,醫學中心,Enterobacter cloacae,Ciprofloxacin,7615,5865,4589,1276,15
2017,醫學中心,Enterobacter cloacae,Ceftazidime,7615,5593,3116,2477,17
2017,醫學中心,Enterobacter cloacae,Ceftriaxone,7615,4718,2584,2134,17
2017,醫學中心,Enterobacter cloacae,Ertapenem,7615,6215,5096,1119,17
2017,醫學中心,Enterobacter cloacae,Gentamicin,7615,6107,5134,973,15
2017,醫學中心,Enterobacter cloacae,Imipenem,7615,5832,5240,592,17
2017,醫學中心,Enterobacter cloacae,Levofloxacin,7615,4891,3821,1070,15
2017,醫學中心,Enterobacter cloacae,Meropenem,7615,2532,2414,118,17
2017,醫學中心,Escherichia coli,Ampicillin/Sulbactam,69138,49448,22286,27162,15
2017,醫學中心,Escherichia coli,Ampicillin,69138,25749,6247,19502,15
2017,醫學中心,Escherichia coli,Amikacin,69138,65001,64472,529,17
2017,醫學中心,Escherichia coli,Cefuroxime sodium,69138,12919,7785,5134,15
2017,醫學中心,Escherichia coli,Cefotaxime,69138,30794,21267,9527,16
2017,醫學中心,Escherichia coli,Ciprofloxacin,69138,64977,40810,24167,17
2017,醫學中心,Escherichia coli,Ceftazidime,69138,40967,29082,11885,17
2017,醫學中心,Escherichia coli,Cefazolin,69138,47106,24867,22239,15
2017,醫學中心,Escherichia coli,Ceftriaxone,69138,42885,28934,13951,17
2017,醫學中心,Escherichia coli,Ertapenem,69138,54918,53900,1018,17
2017,醫學中心,Escherichia coli,Gentamicin,69138,60235,45866,14369,17
2017,醫學中心,Escherichia coli,Imipenem,69138,50774,50290,484,17
2017,醫學中心,Escherichia coli,Levofloxacin,69138,55739,35161,20578,17
2017,醫學中心,Escherichia coli,Meropenem,69138,21259,21104,155,17
2017,醫學中心,Klebsiella pneumoniae,Ampicillin/Sulbactam,48053,25538,14522,11016,15
2017,醫學中心,Klebsiella pneumoniae,Ampicillin,48053,12750,1,12749,15
2017,醫學中心,Klebsiella pneumoniae,Amikacin,48053,33841,31802,2039,17
2017,醫學中心,Klebsiella pneumoniae,Cefuroxime sodium,48053,6852,3886,2966,15
2017,醫學中心,Klebsiella pneumoniae,Cefotaxime,48053,15979,10752,5227,16
2017,醫學中心,Klebsiella pneumoniae,Ciprofloxacin,48053,33817,24182,9635,17
2017,醫學中心,Klebsiella pneumoniae,Ceftazidime,48053,24864,15682,9182,17
2017,醫學中心,Klebsiella pneumoniae,Cefazolin,48053,24215,13149,11066,15
2017,醫學中心,Klebsiella pneumoniae,Ceftriaxone,48053,15611,11222,4389,15
2017,醫學中心,Klebsiella pneumoniae,Ertapenem,48053,37758,32833,4925,22
2017,醫學中心,Klebsiella pneumoniae,Gentamicin,48053,33091,23509,9582,17
2017,醫學中心,Klebsiella pneumoniae,Imipenem,48053,35512,31227,4285,23
2017,醫學中心,Klebsiella pneumoniae,Levofloxacin,48053,23119,17141,5978,15
2017,醫學中心,Klebsiella pneumoniae,Meropenem,48053,12929,11813,1116,22
2017,醫學中心,Proteus mirabilis,Ampicillin/Sulbactam,9349,7422,5217,2205,17
2017,醫學中心,Proteus mirabilis,Ampicillin,9349,3818,1748,2070,16
2017,醫學中心,Proteus mirabilis,Amikacin,9349,7357,7097,260,15
2017,醫學中心,Proteus mirabilis,Cefuroxime sodium,9349,1553,1369,184,15
2017,醫學中心,Proteus mirabilis,Cefotaxime,9349,4191,3664,527,15
2017,醫學中心,Proteus mirabilis,Ciprofloxacin,9349,7330,5246,2084,15
2017,醫學中心,Proteus mirabilis,Cefazolin,9349,8127,4188,3939,17
2017,醫學中心,Proteus mirabilis,Ceftriaxone,9349,4365,3910,455,15
2017,醫學中心,Proteus mirabilis,Gentamicin,9349,8419,5718,2701,17
2017,醫學中心,Proteus mirabilis,Levofloxacin,9349,5843,4449,1394,15
2017,醫學中心,Proteus mirabilis,Meropenem,9349,3511,3407,104,15
2017,醫學中心,Pseudomonas aeruginosa,Amikacin,34187,23979,23243,736,15
2017,醫學中心,Pseudomonas aeruginosa,Cefepime,34187,23123,20214,2909,15
2017,醫學中心,Pseudomonas aeruginosa,Ciprofloxacin,34187,30218,24673,5545,17
2017,醫學中心,Pseudomonas aeruginosa,Ceftazidime,34187,28347,24103,4244,17
2017,醫學中心,Pseudomonas aeruginosa,Gentamicin,34187,24987,22509,2478,17
2017,醫學中心,Pseudomonas aeruginosa,Imipenem,34187,29095,24161,4934,18
2017,醫學中心,Pseudomonas aeruginosa,Levofloxacin,34187,24627,19000,5627,17
2017,醫學中心,Pseudomonas aeruginosa,Meropenem,34187,25448,21930,3518,18
2017,醫學中心,Pseudomonas aeruginosa,Piperacillin/Tazobactam,34187,29079,24061,5018,17
2017,醫學中心,Pseudomonas aeruginosa,Piperacillin,34187,2523,2071,452,17
2017,醫學中心,Enterococcus faecalis,Ampicillin,23328,12860,12763,97,17
2017,醫學中心,Enterococcus faecalis,Gentamicin-High,23328,14962,8256,6706,17
2017,醫學中心,Enterococcus faecalis,Vancomycin,23328,23252,23186,66,23
2017,醫學中心,Enterococcus faecium,Ampicillin,15475,8368,767,7601,17
2017,醫學中心,Enterococcus faecium,Gentamicin-High,15475,10227,4942,5285,17
2017,醫學中心,Enterococcus faecium,Vancomycin,15475,15409,6947,8462,23
2017,醫學中心,Staphylococcus aureus,Ciprofloxacin,45996,16406,11938,4468,16
2017,醫學中心,Staphylococcus aureus,Oxacillin,45996,45933,23848,22085,23
2017,醫學中心,Staphylococcus aureus,Trimethoprim/Sulfamethoxazole,45996,32298,27484,4814,17
2017,醫學中心,Staphylococcus aureus,Vancomycin,45996,35710,35704,6,19
2017,醫學中心,Enterococcus spp.,Ampicillin,3113,2603,2103,500,17
2017,醫學中心,Enterococcus spp.,Gentamicin-High,3113,2726,1984,742,17
2017,醫學中心,Enterococcus spp.,Vancomycin,3113,3105,2734,371,22
2017,區域醫院,Acinetobacter baumannii,Ampicillin/Sulbactam,23849,19635,8615,11020,73
2017,區域醫院,Acinetobacter baumannii,Amikacin,23849,13542,6435,7107,73
2017,區域醫院,Acinetobacter baumannii,Cefepime,23849,18317,6225,12092,73
2017,區域醫院,Acinetobacter baumannii,Ciprofloxacin,23849,13776,4243,9533,73
2017,區域醫院,Acinetobacter baumannii,Ceftazidime,23849,19702,5962,13740,73
2017,區域醫院,Acinetobacter baumannii,Colistin,23849,6914,6640,274,73
2017,區域醫院,Acinetobacter baumannii,Gentamicin,23849,18848,6418,12430,73
2017,區域醫院,Acinetobacter baumannii,Imipenem,23849,20322,7771,12551,80
2017,區域醫院,Acinetobacter baumannii,Levofloxacin,23849,13039,4202,8837,73
2017,區域醫院,Acinetobacter baumannii,Meropenem,23849,10939,4469,6470,79
2017,區域醫院,Acinetobacter baumannii,Piperacillin/Tazobactam,23849,18075,5331,12744,73
2017,區域醫院,Acinetobacter baumannii,Piperacillin,23849,4504,630,3874,72
2017,區域醫院,Acinetobacter baumannii,Tigecycline,23849,9108,7402,1706,72
2017,區域醫院,Enterobacter cloacae,Amikacin,9596,7962,7758,204,71
2017,區域醫院,Enterobacter cloacae,Cefotaxime,9596,4141,2618,1523,71
2017,區域醫院,Enterobacter cloacae,Cefepime,9596,7343,6503,840,71
2017,區域醫院,Enterobacter cloacae,Ciprofloxacin,9596,5737,4605,1132,71
2017,區域醫院,Enterobacter cloacae,Ceftazidime,9596,7217,4951,2266,71
2017,區域醫院,Enterobacter cloacae,Ceftriaxone,9596,5650,3729,1921,71
2017,區域醫院,Enterobacter cloacae,Ertapenem,9596,6942,6253,689,72
2017,區域醫院,Enterobacter cloacae,Gentamicin,9596,8269,7310,959,71
2017,區域醫院,Enterobacter cloacae,Imipenem,9596,6111,5590,521,71
2017,區域醫院,Enterobacter cloacae,Levofloxacin,9596,6090,5113,977,71
2017,區域醫院,Enterobacter cloacae,Meropenem,9596,4076,4005,71,72
2017,區域醫院,Escherichia coli,Ampicillin/Sulbactam,146306,110153,49528,60625,71
2017,區域醫院,Escherichia coli,Ampicillin,146306,61871,13770,48101,71
2017,區域醫院,Escherichia coli,Amikacin,146306,130304,128751,1553,71
2017,區域醫院,Escherichia coli,Cefuroxime sodium,146306,36360,23685,12675,71
2017,區域醫院,Escherichia coli,Cefotaxime,146306,57492,39666,17826,71
2017,區域醫院,Escherichia coli,Ciprofloxacin,146306,101229,61854,39375,71
2017,區域醫院,Escherichia coli,Ceftazidime,146306,101396,75992,25404,71
2017,區域醫院,Escherichia coli,Cefazolin,146306,111585,59532,52053,71
2017,區域醫院,Escherichia coli,Ceftriaxone,146306,92990,63264,29726,71
2017,區域醫院,Escherichia coli,Ertapenem,146306,112631,109186,3445,74
2017,區域醫院,Escherichia coli,Gentamicin,146306,133581,99458,34123,71
2017,區域醫院,Escherichia coli,Imipenem,146306,86515,84993,1522,74
2017,區域醫院,Escherichia coli,Levofloxacin,146306,103454,64531,38923,71
2017,區域醫院,Escherichia coli,Meropenem,146306,54653,52220,2433,73
2017,區域醫院,Klebsiella pneumoniae,Ampicillin/Sulbactam,64631,43328,24250,19078,73
2017,區域醫院,Klebsiella pneumoniae,Ampicillin,64631,21554,420,21134,72
2017,區域醫院,Klebsiella pneumoniae,Amikacin,64631,53009,49440,3569,73
2017,區域醫院,Klebsiella pneumoniae,Cefuroxime sodium,64631,12288,7284,5004,72
2017,區域醫院,Klebsiella pneumoniae,Cefotaxime,64631,23299,14934,8365,73
2017,區域醫院,Klebsiella pneumoniae,Ciprofloxacin,64631,40126,27350,12776,73
2017,區域醫院,Klebsiella pneumoniae,Ceftazidime,64631,43271,28842,14429,73
2017,區域醫院,Klebsiella pneumoniae,Cefazolin,64631,46167,24963,21204,73
2017,區域醫院,Klebsiella pneumoniae,Ceftriaxone,64631,31669,22643,9026,72
2017,區域醫院,Klebsiella pneumoniae,Ertapenem,64631,46818,41009,5809,78
2017,區域醫院,Klebsiella pneumoniae,Gentamicin,64631,54787,39478,15309,73
2017,區域醫院,Klebsiella pneumoniae,Imipenem,64631,40874,35933,4941,80
2017,區域醫院,Klebsiella pneumoniae,Levofloxacin,64631,35309,26030,9279,73
2017,區域醫院,Klebsiella pneumoniae,Meropenem,64631,23781,21869,1912,79
2017,區域醫院,Proteus mirabilis,Ampicillin/Sulbactam,23418,19872,12266,7606,71
2017,區域醫院,Proteus mirabilis,Ampicillin,23418,9260,3031,6229,71
2017,區域醫院,Proteus mirabilis,Amikacin,23418,19744,18049,1695,71
2017,區域醫院,Proteus mirabilis,Cefuroxime sodium,23418,5299,4012,1287,71
2017,區域醫院,Proteus mirabilis,Cefotaxime,23418,10925,8537,2388,71
2017,區域醫院,Proteus mirabilis,Ciprofloxacin,23418,15820,9788,6032,71
2017,區域醫院,Proteus mirabilis,Cefazolin,23418,20899,9146,11753,71
2017,區域醫院,Proteus mirabilis,Ceftriaxone,23418,11068,9190,1878,71
2017,區域醫院,Proteus mirabilis,Gentamicin,23418,22150,12966,9184,71
2017,區域醫院,Proteus mirabilis,Levofloxacin,23418,15032,10362,4670,71
2017,區域醫院,Proteus mirabilis,Meropenem,23418,10974,10712,262,72
2017,區域醫院,Pseudomonas aeruginosa,Amikacin,50240,38868,37229,1639,71
2017,區域醫院,Pseudomonas aeruginosa,Cefepime,50240,38146,33249,4897,71
2017,區域醫院,Pseudomonas aeruginosa,Ciprofloxacin,50240,38065,28970,9095,71
2017,區域醫院,Pseudomonas aeruginosa,Ceftazidime,50240,46868,40272,6596,71
2017,區域醫院,Pseudomonas aeruginosa,Gentamicin,50240,45828,38285,7543,71
2017,區域醫院,Pseudomonas aeruginosa,Imipenem,50240,39752,33647,6105,74
2017,區域醫院,Pseudomonas aeruginosa,Levofloxacin,50240,39253,28674,10579,71
2017,區域醫院,Pseudomonas aeruginosa,Meropenem,50240,30813,26735,4078,74
2017,區域醫院,Pseudomonas aeruginosa,Piperacillin/Tazobactam,50240,44346,37003,7343,71
2017,區域醫院,Pseudomonas aeruginosa,Piperacillin,50240,11810,8702,3108,71
2017,區域醫院,Enterococcus faecalis,Ampicillin,21083,14405,13997,408,72
2017,區域醫院,Enterococcus faecalis,Gentamicin-High,21083,16234,8371,7863,72
2017,區域醫院,Enterococcus faecalis,Vancomycin,21083,20991,20758,233,79
2017,區域醫院,Enterococcus faecium,Ampicillin,11389,8242,836,7406,72
2017,區域醫院,Enterococcus faecium,Gentamicin-High,11389,7659,3504,4155,72
2017,區域醫院,Enterococcus faecium,Vancomycin,11389,11312,5336,5976,79
2017,區域醫院,Staphylococcus aureus,Ciprofloxacin,55581,19292,11356,7936,73
2017,區域醫院,Staphylococcus aureus,Oxacillin,55581,53488,23994,29494,80
2017,區域醫院,Staphylococcus aureus,Trimethoprim/Sulfamethoxazole,55581,49478,41902,7576,73
2017,區域醫院,Staphylococcus aureus,Vancomycin,55581,47201,46971,230,74
2017,區域醫院,Enterococcus spp.,Ampicillin,10331,8613,6445,2168,69
2017,區域醫院,Enterococcus spp.,Gentamicin-High,10331,8404,4659,3745,69
2017,區域醫院,Enterococcus spp.,Vancomycin,10331,10323,8733,1590,73
2017,地區醫院,Acinetobacter baumannii,Ampicillin/Sulbactam,14009,9761,3400,6361,198
2017,地區醫院,Acinetobacter baumannii,Amikacin,14009,9014,2737,6277,197
2017,地區醫院,Acinetobacter baumannii,Cefepime,14009,9682,1465,8217,197
2017,地區醫院,Acinetobacter baumannii,Ciprofloxacin,14009,9097,1235,7862,198
2017,地區醫院,Acinetobacter baumannii,Ceftazidime,14009,11308,2066,9242,197
2017,地區醫院,Acinetobacter baumannii,Colistin,14009,4551,4410,141,195
2017,地區醫院,Acinetobacter baumannii,Gentamicin,14009,10886,2237,8649,198
2017,地區醫院,Acinetobacter baumannii,Imipenem,14009,11603,2705,8898,205
2017,地區醫院,Acinetobacter baumannii,Levofloxacin,14009,8332,1115,7217,196
2017,地區醫院,Acinetobacter baumannii,Meropenem,14009,7302,1609,5693,203
2017,地區醫院,Acinetobacter baumannii,Piperacillin/Tazobactam,14009,10353,1498,8855,198
2017,地區醫院,Acinetobacter baumannii,Piperacillin,14009,2070,216,1854,196
2017,地區醫院,Acinetobacter baumannii,Tigecycline,14009,4597,3380,1217,196
2017,地區醫院,Enterobacter cloacae,Amikacin,3538,2902,2728,174,188
2017,地區醫院,Enterobacter cloacae,Cefotaxime,3538,1069,698,371,188
2017,地區醫院,Enterobacter cloacae,Cefepime,3538,2118,1741,377,188
2017,地區醫院,Enterobacter cloacae,Ciprofloxacin,3538,2199,1542,657,189
2017,地區醫院,Enterobacter cloacae,Ceftazidime,3538,2793,2016,777,190
2017,地區醫院,Enterobacter cloacae,Ceftriaxone,3538,2482,1646,836,189
2017,地區醫院,Enterobacter cloacae,Ertapenem,3538,1950,1769,181,188
2017,地區醫院,Enterobacter cloacae,Gentamicin,3538,3171,2425,746,189
2017,地區醫院,Enterobacter cloacae,Imipenem,3538,2536,2377,159,190
2017,地區醫院,Enterobacter cloacae,Levofloxacin,3538,2279,1588,691,188
2017,地區醫院,Enterobacter cloacae,Meropenem,3538,1455,1352,103,188
2017,地區醫院,Escherichia coli,Ampicillin/Sulbactam,62116,37493,15871,21622,194
2017,地區醫院,Escherichia coli,Ampicillin,62116,29924,6212,23712,195
2017,地區醫院,Escherichia coli,Amikacin,62116,51593,49590,2003,197
2017,地區醫院,Escherichia coli,Cefuroxime sodium,62116,18859,10900,7959,192
2017,地區醫院,Escherichia coli,Cefotaxime,62116,17354,10910,6444,194
2017,地區醫院,Escherichia coli,Ciprofloxacin,62116,46193,23912,22281,197
2017,地區醫院,Escherichia coli,Ceftazidime,62116,47449,31469,15980,197
2017,地區醫院,Escherichia coli,Cefazolin,62116,49063,21438,27625,195
2017,地區醫院,Escherichia coli,Ceftriaxone,62116,42724,26323,16401,196
2017,地區醫院,Escherichia coli,Ertapenem,62116,36790,34517,2273,194
2017,地區醫院,Escherichia coli,Gentamicin,62116,58878,41206,17672,197
2017,地區醫院,Escherichia coli,Imipenem,62116,40562,38733,1829,199
2017,地區醫院,Escherichia coli,Levofloxacin,62116,38454,20287,18167,196
2017,地區醫院,Escherichia coli,Meropenem,62116,31723,29336,2387,195
2017,地區醫院,Klebsiella pneumoniae,Ampicillin/Sulbactam,30076,15699,7106,8593,196
2017,地區醫院,Klebsiella pneumoniae,Ampicillin,30076,14643,469,14174,195
2017,地區醫院,Klebsiella pneumoniae,Amikacin,30076,22492,19920,2572,198
2017,地區醫院,Klebsiella pneumoniae,Cefuroxime sodium,30076,8200,4302,3898,194
2017,地區醫院,Klebsiella pneumoniae,Cefotaxime,30076,7926,4972,2954,195
2017,地區醫院,Klebsiella pneumoniae,Ciprofloxacin,30076,20285,12058,8227,198
2017,地區醫院,Klebsiella pneumoniae,Ceftazidime,30076,21861,13183,8678,197
2017,地區醫院,Klebsiella pneumoniae,Cefazolin,30076,21417,9668,11749,196
2017,地區醫院,Klebsiella pneumoniae,Ceftriaxone,30076,17644,11003,6641,196
2017,地區醫院,Klebsiella pneumoniae,Ertapenem,30076,18347,15239,3108,201
2017,地區醫院,Klebsiella pneumoniae,Gentamicin,30076,25633,17509,8124,198
2017,地區醫院,Klebsiella pneumoniae,Imipenem,30076,22062,19369,2693,205
2017,地區醫院,Klebsiella pneumoniae,Levofloxacin,30076,15302,9388,5914,196
2017,地區醫院,Klebsiella pneumoniae,Meropenem,30076,12873,11016,1857,201
2017,地區醫院,Proteus mirabilis,Ampicillin/Sulbactam,15063,10032,4253,5779,193
2017,地區醫院,Proteus mirabilis,Ampicillin,15063,8121,1568,6553,192
2017,地區醫院,Proteus mirabilis,Amikacin,15063,12631,9363,3268,193
2017,地區醫院,Proteus mirabilis,Cefuroxime sodium,15063,3875,2534,1341,189
2017,地區醫院,Proteus mirabilis,Cefotaxime,15063,4259,2817,1442,190
2017,地區醫院,Proteus mirabilis,Ciprofloxacin,15063,11166,5050,6116,193
2017,地區醫院,Proteus mirabilis,Cefazolin,15063,11521,3138,8383,192
2017,地區醫院,Proteus mirabilis,Ceftriaxone,15063,10235,7035,3200,192
2017,地區醫院,Proteus mirabilis,Gentamicin,15063,14457,5446,9011,195
2017,地區醫院,Proteus mirabilis,Levofloxacin,15063,9395,4599,4796,191
2017,地區醫院,Proteus mirabilis,Meropenem,15063,7652,6807,845,189
2017,地區醫院,Pseudomonas aeruginosa,Amikacin,28718,24512,22317,2195,194
2017,地區醫院,Pseudomonas aeruginosa,Cefepime,28718,21043,16306,4737,192
2017,地區醫院,Pseudomonas aeruginosa,Ciprofloxacin,28718,22317,11894,10423,194
2017,地區醫院,Pseudomonas aeruginosa,Ceftazidime,28718,26600,21126,5474,194
2017,地區醫院,Pseudomonas aeruginosa,Gentamicin,28718,26278,17258,9020,195
2017,地區醫院,Pseudomonas aeruginosa,Imipenem,28718,21974,16714,5260,196
2017,地區醫院,Pseudomonas aeruginosa,Levofloxacin,28718,20632,10126,10506,192
2017,地區醫院,Pseudomonas aeruginosa,Meropenem,28718,17723,13403,4320,193
2017,地區醫院,Pseudomonas aeruginosa,Piperacillin/Tazobactam,28718,24801,18372,6429,193
2017,地區醫院,Pseudomonas aeruginosa,Piperacillin,28718,7028,4620,2408,193
2017,地區醫院,Enterococcus faecalis,Ampicillin,5469,3989,3855,134,182
2017,地區醫院,Enterococcus faecalis,Gentamicin-High,5469,3921,1706,2215,182
2017,地區醫院,Enterococcus faecalis,Vancomycin,5469,5433,5286,147,186
2017,地區醫院,Enterococcus faecium,Ampicillin,2550,1924,133,1791,179
2017,地區醫院,Enterococcus faecium,Gentamicin-High,2550,1866,777,1089,178
2017,地區醫院,Enterococcus faecium,Vancomycin,2550,2511,1316,1195,182
2017,地區醫院,Staphylococcus aureus,Ciprofloxacin,25063,9811,5610,4201,201
2017,地區醫院,Staphylococcus aureus,Oxacillin,25063,24330,9886,14444,208
2017,地區醫院,Staphylococcus aureus,Trimethoprim/Sulfamethoxazole,25063,19144,16195,2949,203
2017,地區醫院,Staphylococcus aureus,Vancomycin,25063,22721,22548,173,206
2017,地區醫院,Enterococcus spp.,Ampicillin,7018,3593,2499,1094,192
2017,地區醫院,Enterococcus spp.,Gentamicin-High,7018,4091,2048,2043,191
2017,地區醫院,Enterococcus spp.,Vancomycin,7018,6956,5851,1105,198
2016,醫學中心,Acinetobacter baumannii,Ampicillin/Sulbactam,24385,13650,7372,6278,17
2016,醫學中心,Acinetobacter baumannii,Amikacin,24385,12122,5228,6894,17
2016,醫學中心,Acinetobacter baumannii,Cefepime,24385,17158,7082,10076,17
2016,醫學中心,Acinetobacter baumannii,Ciprofloxacin,24385,18076,6660,11416,17
2016,醫學中心,Acinetobacter baumannii,Ceftazidime,24385,18179,7296,10883,17
2016,醫學中心,Acinetobacter baumannii,Colistin,24385,10685,10471,214,15
2016,醫學中心,Acinetobacter baumannii,Gentamicin,24385,14371,5686,8685,17
2016,醫學中心,Acinetobacter baumannii,Imipenem,24385,24297,10003,14294,23
2016,醫學中心,Acinetobacter baumannii,Levofloxacin,24385,11680,4709,6971,17
2016,醫學中心,Acinetobacter baumannii,Meropenem,24385,15682,7098,8584,22
2016,醫學中心,Acinetobacter baumannii,Piperacillin/Tazobactam,24385,17193,6346,10847,17
2016,醫學中心,Acinetobacter baumannii,Piperacillin,24385,1088,366,722,15
2016,醫學中心,Acinetobacter baumannii,Tigecycline,24385,8793,5749,3044,15
2016,醫學中心,Enterobacter cloacae,Amikacin,8474,6311,6243,68,15
2016,醫學中心,Enterobacter cloacae,Cefotaxime,8474,3249,1945,1304,16
2016,醫學中心,Enterobacter cloacae,Cefepime,8474,5919,5061,858,15
2016,醫學中心,Enterobacter cloacae,Ciprofloxacin,8474,6052,4951,1101,15
2016,醫學中心,Enterobacter cloacae,Ceftazidime,8474,6217,3632,2585,17
2016,醫學中心,Enterobacter cloacae,Ceftriaxone,8474,5384,3077,2307,17
2016,醫學中心,Enterobacter cloacae,Ertapenem,8474,7450,6288,1162,17
2016,醫學中心,Enterobacter cloacae,Gentamicin,8474,6555,5539,1016,15
2016,醫學中心,Enterobacter cloacae,Imipenem,8474,6194,5606,588,17
2016,醫學中心,Enterobacter cloacae,Levofloxacin,8474,5007,4164,843,15
2016,醫學中心,Enterobacter cloacae,Meropenem,8474,2644,2535,109,17
2016,醫學中心,Escherichia coli,Ampicillin/Sulbactam,82656,50984,23603,27381,15
2016,醫學中心,Escherichia coli,Ampicillin,82656,30115,8762,21353,15
2016,醫學中心,Escherichia coli,Amikacin,82656,80326,79728,598,17
2016,醫學中心,Escherichia coli,Cefuroxime sodium,82656,14985,9260,5725,15
2016,醫學中心,Escherichia coli,Cefotaxime,82656,31312,22283,9029,16
2016,醫學中心,Escherichia coli,Ciprofloxacin,82656,77681,49054,28627,17
2016,醫學中心,Escherichia coli,Ceftazidime,82656,45453,32885,12568,17
2016,醫學中心,Escherichia coli,Cefazolin,82656,48994,25988,23006,15
2016,醫學中心,Escherichia coli,Ceftriaxone,82656,55621,38043,17578,17
2016,醫學中心,Escherichia coli,Ertapenem,82656,72607,71634,973,17
2016,醫學中心,Escherichia coli,Gentamicin,82656,73890,55417,18473,17
2016,醫學中心,Escherichia coli,Imipenem,82656,52344,51884,460,17
2016,醫學中心,Escherichia coli,Levofloxacin,82656,69908,44361,25547,17
2016,醫學中心,Escherichia coli,Meropenem,82656,20567,20485,82,17
2016,醫學中心,Klebsiella pneumoniae,Ampicillin/Sulbactam,51453,25880,15087,10793,16
2016,醫學中心,Klebsiella pneumoniae,Ampicillin,51453,14168,441,13727,16
2016,醫學中心,Klebsiella pneumoniae,Amikacin,51453,36138,34118,2020,17
2016,醫學中心,Klebsiella pneumoniae,Cefuroxime sodium,51453,8245,4299,3946,15
2016,醫學中心,Klebsiella pneumoniae,Cefotaxime,51453,16346,11193,5153,16
2016,醫學中心,Klebsiella pneumoniae,Ciprofloxacin,51453,35290,25348,9942,17
2016,醫學中心,Klebsiella pneumoniae,Ceftazidime,51453,26208,17181,9027,17
2016,醫學中心,Klebsiella pneumoniae,Cefazolin,51453,25135,13402,11733,16
2016,醫學中心,Klebsiella pneumoniae,Ceftriaxone,51453,14872,10868,4004,16
2016,醫學中心,Klebsiella pneumoniae,Ertapenem,51453,42079,37139,4940,22
2016,醫學中心,Klebsiella pneumoniae,Gentamicin,51453,34741,24990,9751,17
2016,醫學中心,Klebsiella pneumoniae,Imipenem,51453,37265,33674,3591,23
2016,醫學中心,Klebsiella pneumoniae,Levofloxacin,51453,23894,17711,6183,16
2016,醫學中心,Klebsiella pneumoniae,Meropenem,51453,13467,12327,1140,22
2016,醫學中心,Proteus mirabilis,Ampicillin/Sulbactam,10433,7966,5691,2275,17
2016,醫學中心,Proteus mirabilis,Ampicillin,10433,4146,1791,2355,16
2016,醫學中心,Proteus mirabilis,Amikacin,10433,7475,7250,225,15
2016,醫學中心,Proteus mirabilis,Cefuroxime sodium,10433,2010,1766,244,15
2016,醫學中心,Proteus mirabilis,Cefotaxime,10433,4186,3746,440,15
2016,醫學中心,Proteus mirabilis,Ciprofloxacin,10433,7398,5323,2075,15
2016,醫學中心,Proteus mirabilis,Cefazolin,10433,9670,4869,4801,17
2016,醫學中心,Proteus mirabilis,Ceftriaxone,10433,4304,3808,496,15
2016,醫學中心,Proteus mirabilis,Gentamicin,10433,9601,6638,2963,17
2016,醫學中心,Proteus mirabilis,Levofloxacin,10433,6199,4724,1475,15
2016,醫學中心,Proteus mirabilis,Meropenem,10433,2936,2834,102,15
2016,醫學中心,Pseudomonas aeruginosa,Amikacin,37740,26488,25770,718,15
2016,醫學中心,Pseudomonas aeruginosa,Cefepime,37740,25313,21788,3525,15
2016,醫學中心,Pseudomonas aeruginosa,Ciprofloxacin,37740,34080,27552,6528,17
2016,醫學中心,Pseudomonas aeruginosa,Ceftazidime,37740,34107,28849,5258,17
2016,醫學中心,Pseudomonas aeruginosa,Gentamicin,37740,31377,28002,3375,17
2016,醫學中心,Pseudomonas aeruginosa,Imipenem,37740,33906,28132,5774,17
2016,醫學中心,Pseudomonas aeruginosa,Levofloxacin,37740,30317,23184,7133,17
2016,醫學中心,Pseudomonas aeruginosa,Meropenem,37740,25367,21988,3379,18
2016,醫學中心,Pseudomonas aeruginosa,Piperacillin/Tazobactam,37740,32721,27034,5687,17
2016,醫學中心,Pseudomonas aeruginosa,Piperacillin,37740,10263,8232,2031,17
2016,醫學中心,Enterococcus faecalis,Ampicillin,22841,12040,11509,531,17
2016,醫學中心,Enterococcus faecalis,Gentamicin-High,22841,11494,6363,5131,16
2016,醫學中心,Enterococcus faecalis,Vancomycin,22841,22827,22750,77,23
2016,醫學中心,Enterococcus faecium,Ampicillin,14822,7733,833,6900,17
2016,醫學中心,Enterococcus faecium,Gentamicin-High,14822,8169,3371,4798,16
2016,醫學中心,Enterococcus faecium,Vancomycin,14822,14797,6426,8371,23
2016,醫學中心,Staphylococcus aureus,Ciprofloxacin,50530,17191,12970,4221,16
2016,醫學中心,Staphylococcus aureus,Oxacillin,50530,50482,25318,25164,23
2016,醫學中心,Staphylococcus aureus,Trimethoprim/Sulfamethoxazole,50530,33154,27769,5385,17
2016,醫學中心,Staphylococcus aureus,Vancomycin,50530,39990,39976,14,18
2016,醫學中心,Enterococcus spp.,Ampicillin,5135,4071,3259,812,17
2016,醫學中心,Enterococcus spp.,Gentamicin-High,5135,4235,2980,1255,16
2016,醫學中心,Enterococcus spp.,Vancomycin,5135,5121,4646,475,22
2016,區域醫院,Acinetobacter baumannii,Ampicillin/Sulbactam,28093,23588,10401,13187,72
2016,區域醫院,Acinetobacter baumannii,Amikacin,28093,17479,8331,9148,72
2016,區域醫院,Acinetobacter baumannii,Cefepime,28093,22564,7919,14645,72
2016,區域醫院,Acinetobacter baumannii,Ciprofloxacin,28093,17425,5931,11494,72
2016,區域醫院,Acinetobacter baumannii,Ceftazidime,28093,23760,7622,16138,72
2016,區域醫院,Acinetobacter baumannii,Colistin,28093,10659,10450,209,72
2016,區域醫院,Acinetobacter baumannii,Gentamicin,28093,23628,8183,15445,72
2016,區域醫院,Acinetobacter baumannii,Imipenem,28093,23127,9500,13627,79
2016,區域醫院,Acinetobacter baumannii,Levofloxacin,28093,17619,6147,11472,72
2016,區域醫院,Acinetobacter baumannii,Meropenem,28093,16684,7636,9048,77
2016,區域醫院,Acinetobacter baumannii,Piperacillin/Tazobactam,28093,22813,7297,15516,72
2016,區域醫院,Acinetobacter baumannii,Piperacillin,28093,6333,1645,4688,72
2016,區域醫院,Acinetobacter baumannii,Tigecycline,28093,14364,11038,3326,72
2016,區域醫院,Enterobacter cloacae,Amikacin,10629,9114,8912,202,70
2016,區域醫院,Enterobacter cloacae,Cefotaxime,10629,4456,3040,1416,70
2016,區域醫院,Enterobacter cloacae,Cefepime,10629,8350,7400,950,70
2016,區域醫院,Enterobacter cloacae,Ciprofloxacin,10629,6707,5421,1286,70
2016,區域醫院,Enterobacter cloacae,Ceftazidime,10629,7926,5660,2266,70
2016,區域醫院,Enterobacter cloacae,Ceftriaxone,10629,6794,4553,2241,70
2016,區域醫院,Enterobacter cloacae,Ertapenem,10629,7753,7023,730,71
2016,區域醫院,Enterobacter cloacae,Gentamicin,10629,9378,8103,1275,70
2016,區域醫院,Enterobacter cloacae,Imipenem,10629,6567,5923,644,71
2016,區域醫院,Enterobacter cloacae,Levofloxacin,10629,7456,6358,1098,70
2016,區域醫院,Enterobacter cloacae,Meropenem,10629,5337,5213,124,71
2016,區域醫院,Escherichia coli,Ampicillin/Sulbactam,152124,119049,54518,64531,70
2016,區域醫院,Escherichia coli,Ampicillin,152124,72823,20264,52559,70
2016,區域醫院,Escherichia coli,Amikacin,152124,138841,137015,1826,70
2016,區域醫院,Escherichia coli,Cefuroxime sodium,152124,35574,23753,11821,70
2016,區域醫院,Escherichia coli,Cefotaxime,152124,64692,43420,21272,71
2016,區域醫院,Escherichia coli,Ciprofloxacin,152124,105391,63171,42220,70
2016,區域醫院,Escherichia coli,Ceftazidime,152124,102907,77179,25728,70
2016,區域醫院,Escherichia coli,Cefazolin,152124,119007,60019,58988,70
2016,區域醫院,Escherichia coli,Ceftriaxone,152124,93489,64275,29214,70
2016,區域醫院,Escherichia coli,Ertapenem,152124,113810,112169,1641,73
2016,區域醫院,Escherichia coli,Gentamicin,152124,143536,104444,39092,70
2016,區域醫院,Escherichia coli,Imipenem,152124,93027,92091,936,73
2016,區域醫院,Escherichia coli,Levofloxacin,152124,114664,71264,43400,70
2016,區域醫院,Escherichia coli,Meropenem,152124,66510,65740,770,72
2016,區域醫院,Klebsiella pneumoniae,Ampicillin/Sulbactam,67887,48149,26120,22029,72
2016,區域醫院,Klebsiella pneumoniae,Ampicillin,67887,28422,641,27781,72
2016,區域醫院,Klebsiella pneumoniae,Amikacin,67887,57969,54750,3219,72
2016,區域醫院,Klebsiella pneumoniae,Cefuroxime sodium,67887,12001,6969,5032,72
2016,區域醫院,Klebsiella pneumoniae,Cefotaxime,67887,26468,16263,10205,72
2016,區域醫院,Klebsiella pneumoniae,Ciprofloxacin,67887,46076,30435,15641,72
2016,區域醫院,Klebsiella pneumoniae,Ceftazidime,67887,46038,30386,15652,72
2016,區域醫院,Klebsiella pneumoniae,Cefazolin,67887,50426,25478,24948,72
2016,區域醫院,Klebsiella pneumoniae,Ceftriaxone,67887,33663,24133,9530,72
2016,區域醫院,Klebsiella pneumoniae,Ertapenem,67887,46150,39916,6234,77
2016,區域醫院,Klebsiella pneumoniae,Gentamicin,67887,60047,43464,16583,72
2016,區域醫院,Klebsiella pneumoniae,Imipenem,67887,44193,39177,5016,79
2016,區域醫院,Klebsiella pneumoniae,Levofloxacin,67887,41136,29077,12059,72
2016,區域醫院,Klebsiella pneumoniae,Meropenem,67887,30161,28015,2146,77
2016,區域醫院,Proteus mirabilis,Ampicillin/Sulbactam,23639,20466,12478,7988,70
2016,區域醫院,Proteus mirabilis,Ampicillin,23639,13420,4161,9259,70
2016,區域醫院,Proteus mirabilis,Amikacin,23639,20519,18937,1582,70
2016,區域醫院,Proteus mirabilis,Cefuroxime sodium,23639,5582,4201,1381,70
2016,區域醫院,Proteus mirabilis,Cefotaxime,23639,11798,9041,2757,70
2016,區域醫院,Proteus mirabilis,Ciprofloxacin,23639,16416,10249,6167,70
2016,區域醫院,Proteus mirabilis,Cefazolin,23639,21209,8833,12376,70
2016,區域醫院,Proteus mirabilis,Ceftriaxone,23639,11678,9886,1792,70
2016,區域醫院,Proteus mirabilis,Gentamicin,23639,22745,13241,9504,70
2016,區域醫院,Proteus mirabilis,Levofloxacin,23639,16803,11553,5250,70
2016,區域醫院,Proteus mirabilis,Meropenem,23639,12210,12073,137,71
2016,區域醫院,Pseudomonas aeruginosa,Amikacin,57237,46334,44447,1887,70
2016,區域醫院,Pseudomonas aeruginosa,Cefepime,57237,46011,39736,6275,70
2016,區域醫院,Pseudomonas aeruginosa,Ciprofloxacin,57237,43530,32101,11429,70
2016,區域醫院,Pseudomonas aeruginosa,Ceftazidime,57237,54035,46440,7595,70
2016,區域醫院,Pseudomonas aeruginosa,Gentamicin,57237,53860,44335,9525,70
2016,區域醫院,Pseudomonas aeruginosa,Imipenem,57237,45220,39243,5977,72
2016,區域醫院,Pseudomonas aeruginosa,Levofloxacin,57237,45581,32737,12844,70
2016,區域醫院,Pseudomonas aeruginosa,Meropenem,57237,39567,35008,4559,72
2016,區域醫院,Pseudomonas aeruginosa,Piperacillin/Tazobactam,57237,52417,44322,8095,70
2016,區域醫院,Pseudomonas aeruginosa,Piperacillin,57237,18223,14110,4113,70
2016,區域醫院,Enterococcus faecalis,Ampicillin,22696,15893,15152,741,70
2016,區域醫院,Enterococcus faecalis,Gentamicin-High,22696,16972,8877,8095,70
2016,區域醫院,Enterococcus faecalis,Vancomycin,22696,22541,22305,236,77
2016,區域醫院,Enterococcus faecium,Ampicillin,10551,7783,731,7052,71
2016,區域醫院,Enterococcus faecium,Gentamicin-High,10551,7200,3022,4178,71
2016,區域醫院,Enterococcus faecium,Vancomycin,10551,10344,5154,5190,78
2016,區域醫院,Staphylococcus aureus,Ciprofloxacin,58749,17451,11070,6381,72
2016,區域醫院,Staphylococcus aureus,Oxacillin,58749,57314,26153,31161,79
2016,區域醫院,Staphylococcus aureus,Trimethoprim/Sulfamethoxazole,58749,51472,42710,8762,72
2016,區域醫院,Staphylococcus aureus,Vancomycin,58749,49310,49083,227,73
2016,區域醫院,Enterococcus spp.,Ampicillin,12197,9775,7162,2613,67
2016,區域醫院,Enterococcus spp.,Gentamicin-High,12197,9292,5089,4203,67
2016,區域醫院,Enterococcus spp.,Vancomycin,12197,12149,10419,1730,71
2016,地區醫院,Acinetobacter baumannii,Ampicillin/Sulbactam,14539,9642,3075,6567,179
2016,地區醫院,Acinetobacter baumannii,Amikacin,14539,9332,2664,6668,179
2016,地區醫院,Acinetobacter baumannii,Cefepime,14539,9514,1453,8061,179
2016,地區醫院,Acinetobacter baumannii,Ciprofloxacin,14539,8931,1188,7743,177
2016,地區醫院,Acinetobacter baumannii,Ceftazidime,14539,11748,1990,9758,181
2016,地區醫院,Acinetobacter baumannii,Colistin,14539,4406,4293,113,175
2016,地區醫院,Acinetobacter baumannii,Gentamicin,14539,11086,2171,8915,179
2016,地區醫院,Acinetobacter baumannii,Imipenem,14539,12587,3055,9532,186
2016,地區醫院,Acinetobacter baumannii,Levofloxacin,14539,8963,1183,7780,178
2016,地區醫院,Acinetobacter baumannii,Meropenem,14539,7160,1720,5440,183
2016,地區醫院,Acinetobacter baumannii,Piperacillin/Tazobactam,14539,10646,1693,8953,179
2016,地區醫院,Acinetobacter baumannii,Piperacillin,14539,2657,222,2435,175
2016,地區醫院,Acinetobacter baumannii,Tigecycline,14539,4909,3713,1196,174
2016,地區醫院,Enterobacter cloacae,Amikacin,3035,2572,2383,189,166
2016,地區醫院,Enterobacter cloacae,Cefotaxime,3035,1125,744,381,167
2016,地區醫院,Enterobacter cloacae,Cefepime,3035,1776,1510,266,166
2016,地區醫院,Enterobacter cloacae,Ciprofloxacin,3035,1925,1410,515,166
2016,地區醫院,Enterobacter cloacae,Ceftazidime,3035,2458,1823,635,169
2016,地區醫院,Enterobacter cloacae,Ceftriaxone,3035,2124,1435,689,167
2016,地區醫院,Enterobacter cloacae,Ertapenem,3035,1725,1567,158,168
2016,地區醫院,Enterobacter cloacae,Gentamicin,3035,2800,2197,603,166
2016,地區醫院,Enterobacter cloacae,Imipenem,3035,2282,2146,136,169
2016,地區醫院,Enterobacter cloacae,Levofloxacin,3035,1959,1482,477,165
2016,地區醫院,Enterobacter cloacae,Meropenem,3035,1197,1148,49,168
2016,地區醫院,Escherichia coli,Ampicillin/Sulbactam,59262,32754,14685,18069,175
2016,地區醫院,Escherichia coli,Ampicillin,59262,27983,6003,21980,174
2016,地區醫院,Escherichia coli,Amikacin,59262,49247,47098,2149,178
2016,地區醫院,Escherichia coli,Cefuroxime sodium,59262,14214,8043,6171,175
2016,地區醫院,Escherichia coli,Cefotaxime,59262,19867,12849,7018,176
2016,地區醫院,Escherichia coli,Ciprofloxacin,59262,43421,23350,20071,178
2016,地區醫院,Escherichia coli,Ceftazidime,59262,44626,29920,14706,178
2016,地區醫院,Escherichia coli,Cefazolin,59262,44984,19481,25503,175
2016,地區醫院,Escherichia coli,Ceftriaxone,59262,37811,23500,14311,176
2016,地區醫院,Escherichia coli,Ertapenem,59262,35580,33672,1908,178
2016,地區醫院,Escherichia coli,Gentamicin,59262,55901,38049,17852,178
2016,地區醫院,Escherichia coli,Imipenem,59262,37632,36167,1465,179
2016,地區醫院,Escherichia coli,Levofloxacin,59262,37137,20357,16780,178
2016,地區醫院,Escherichia coli,Meropenem,59262,29060,27832,1228,177
2016,地區醫院,Klebsiella pneumoniae,Ampicillin/Sulbactam,28629,14197,6235,7962,179
2016,地區醫院,Klebsiella pneumoniae,Ampicillin,28629,13092,378,12714,179
2016,地區醫院,Klebsiella pneumoniae,Amikacin,28629,21467,18824,2643,182
2016,地區醫院,Klebsiella pneumoniae,Cefuroxime sodium,28629,6490,3384,3106,179
2016,地區醫院,Klebsiella pneumoniae,Cefotaxime,28629,7989,4942,3047,180
2016,地區醫院,Klebsiella pneumoniae,Ciprofloxacin,28629,18473,10933,7540,182
2016,地區醫院,Klebsiella pneumoniae,Ceftazidime,28629,20573,12340,8233,182
2016,地區醫院,Klebsiella pneumoniae,Cefazolin,28629,19609,8800,10809,179
2016,地區醫院,Klebsiella pneumoniae,Ceftriaxone,28629,15501,9732,5769,179
2016,地區醫院,Klebsiella pneumoniae,Ertapenem,28629,17375,14672,2703,186
2016,地區醫院,Klebsiella pneumoniae,Gentamicin,28629,23801,15975,7826,182
2016,地區醫院,Klebsiella pneumoniae,Imipenem,28629,21690,19246,2444,188
2016,地區醫院,Klebsiella pneumoniae,Levofloxacin,28629,14364,9129,5235,179
2016,地區醫院,Klebsiella pneumoniae,Meropenem,28629,12287,10882,1405,185
2016,地區醫院,Proteus mirabilis,Ampicillin/Sulbactam,15012,9668,3999,5669,176
2016,地區醫院,Proteus mirabilis,Ampicillin,15012,8047,1510,6537,175
2016,地區醫院,Proteus mirabilis,Amikacin,15012,12741,9518,3223,174
2016,地區醫院,Proteus mirabilis,Cefuroxime sodium,15012,3511,2194,1317,174
2016,地區醫院,Proteus mirabilis,Cefotaxime,15012,4942,3200,1742,174
2016,地區醫院,Proteus mirabilis,Ciprofloxacin,15012,10869,5087,5782,174
2016,地區醫院,Proteus mirabilis,Cefazolin,15012,11478,3045,8433,175
2016,地區醫院,Proteus mirabilis,Ceftriaxone,15012,9745,6868,2877,173
2016,地區醫院,Proteus mirabilis,Gentamicin,15012,14432,5130,9302,177
2016,地區醫院,Proteus mirabilis,Levofloxacin,15012,9322,4795,4527,174
2016,地區醫院,Proteus mirabilis,Meropenem,15012,8105,7374,731,174
2016,地區醫院,Pseudomonas aeruginosa,Amikacin,28073,24477,22204,2273,176
2016,地區醫院,Pseudomonas aeruginosa,Cefepime,28073,20796,16113,4683,176
2016,地區醫院,Pseudomonas aeruginosa,Ciprofloxacin,28073,22116,11840,10276,179
2016,地區醫院,Pseudomonas aeruginosa,Ceftazidime,28073,26173,20834,5339,179
2016,地區醫院,Pseudomonas aeruginosa,Gentamicin,28073,26136,17097,9039,179
2016,地區醫院,Pseudomonas aeruginosa,Imipenem,28073,21326,16052,5274,179
2016,地區醫院,Pseudomonas aeruginosa,Levofloxacin,28073,20991,10247,10744,179
2016,地區醫院,Pseudomonas aeruginosa,Meropenem,28073,16695,12719,3976,179
2016,地區醫院,Pseudomonas aeruginosa,Piperacillin/Tazobactam,28073,24407,18290,6117,179
2016,地區醫院,Pseudomonas aeruginosa,Piperacillin,28073,9464,5859,3605,179
2016,地區醫院,Enterococcus faecalis,Ampicillin,4799,3346,3202,144,164
2016,地區醫院,Enterococcus faecalis,Gentamicin-High,4799,3216,1345,1871,164
2016,地區醫院,Enterococcus faecalis,Vancomycin,4799,4751,4645,106,168
2016,地區醫院,Enterococcus faecium,Ampicillin,2099,1636,150,1486,162
2016,地區醫院,Enterococcus faecium,Gentamicin-High,2099,1545,575,970,163
2016,地區醫院,Enterococcus faecium,Vancomycin,2099,2078,1076,1002,168
2016,地區醫院,Staphylococcus aureus,Ciprofloxacin,26204,8715,5451,3264,181
2016,地區醫院,Staphylococcus aureus,Oxacillin,26204,25215,10117,15098,190
2016,地區醫院,Staphylococcus aureus,Trimethoprim/Sulfamethoxazole,26204,18265,15224,3041,184
2016,地區醫院,Staphylococcus aureus,Vancomycin,26204,23105,22597,508,187
2016,地區醫院,Enterococcus spp.,Ampicillin,6549,3627,2560,1067,173
2016,地區醫院,Enterococcus spp.,Gentamicin-High,6549,3573,1649,1924,171
2016,地區醫院,Enterococcus spp.,Vancomycin,6549,6504,5567,937,179
2015,醫學中心,Acinetobacter baumannii,Ampicillin/Sulbactam,24634,15961,8227,7734,17
2015,醫學中心,Acinetobacter baumannii,Amikacin,24634,11730,4738,6992,17
2015,醫學中心,Acinetobacter baumannii,Cefepime,24634,16538,6593,9945,17
2015,醫學中心,Acinetobacter baumannii,Ciprofloxacin,24634,17048,6247,10801,17
2015,醫學中心,Acinetobacter baumannii,Ceftazidime,24634,17047,6719,10328,17
2015,醫學中心,Acinetobacter baumannii,Colistin,24634,8823,8706,117,17
2015,醫學中心,Acinetobacter baumannii,Gentamicin,24634,15502,6336,9166,17
2015,醫學中心,Acinetobacter baumannii,Imipenem,24634,23080,9265,13815,23
2015,醫學中心,Acinetobacter baumannii,Levofloxacin,24634,12136,4658,7478,17
2015,醫學中心,Acinetobacter baumannii,Meropenem,24634,14463,6477,7986,22
2015,醫學中心,Acinetobacter baumannii,Piperacillin/Tazobactam,24634,15189,5579,9610,17
2015,醫學中心,Acinetobacter baumannii,Piperacillin,24634,1512,448,1064,17
2015,醫學中心,Acinetobacter baumannii,Tigecycline,24634,9356,6562,2794,17
2015,醫學中心,Enterobacter cloacae,Amikacin,8549,6549,6484,65,17
2015,醫學中心,Enterobacter cloacae,Cefotaxime,8549,3322,1984,1338,17
2015,醫學中心,Enterobacter cloacae,Cefepime,8549,6138,5365,773,17
2015,醫學中心,Enterobacter cloacae,Ciprofloxacin,8549,6001,4872,1129,17
2015,醫學中心,Enterobacter cloacae,Ceftazidime,8549,6100,3721,2379,17
2015,醫學中心,Enterobacter cloacae,Ceftriaxone,8549,5213,3092,2121,17
2015,醫學中心,Enterobacter cloacae,Ertapenem,8549,7121,5943,1178,17
2015,醫學中心,Enterobacter cloacae,Gentamicin,8549,6648,5537,1111,17
2015,醫學中心,Enterobacter cloacae,Imipenem,8549,6269,5632,637,17
2015,醫學中心,Enterobacter cloacae,Levofloxacin,8549,5406,4476,930,17
2015,醫學中心,Enterobacter cloacae,Meropenem,8549,2698,2541,157,17
2015,醫學中心,Escherichia coli,Ampicillin/Sulbactam,92189,46356,21121,25235,17
2015,醫學中心,Escherichia coli,Ampicillin,92189,34556,8760,25796,17
2015,醫學中心,Escherichia coli,Amikacin,92189,73888,73343,545,17
2015,醫學中心,Escherichia coli,Cefuroxime sodium,92189,13762,8828,4934,17
2015,醫學中心,Escherichia coli,Cefotaxime,92189,30267,21893,8374,17
2015,醫學中心,Escherichia coli,Ciprofloxacin,92189,69768,44746,25022,17
2015,醫學中心,Escherichia coli,Ceftazidime,92189,41789,31173,10616,17
2015,醫學中心,Escherichia coli,Cefazolin,92189,45613,24744,20869,17
2015,醫學中心,Escherichia coli,Ceftriaxone,92189,47714,33204,14510,17
2015,醫學中心,Escherichia coli,Ertapenem,92189,62374,61502,872,17
2015,醫學中心,Escherichia coli,Gentamicin,92189,69676,52488,17188,17
2015,醫學中心,Escherichia coli,Imipenem,92189,50269,49950,319,17
2015,醫學中心,Escherichia coli,Levofloxacin,92189,63078,40584,22494,17
2015,醫學中心,Escherichia coli,Meropenem,92189,21309,21219,90,17
2015,醫學中心,Klebsiella pneumoniae,Ampicillin/Sulbactam,48298,23684,14145,9539,17
2015,醫學中心,Klebsiella pneumoniae,Ampicillin,48298,17505,5,17500,17
2015,醫學中心,Klebsiella pneumoniae,Amikacin,48298,34200,31960,2240,17
2015,醫學中心,Klebsiella pneumoniae,Cefuroxime sodium,48298,6681,3787,2894,17
2015,醫學中心,Klebsiella pneumoniae,Cefotaxime,48298,15755,11028,4727,17
2015,醫學中心,Klebsiella pneumoniae,Ciprofloxacin,48298,31787,23015,8772,17
2015,醫學中心,Klebsiella pneumoniae,Ceftazidime,48298,23626,16025,7601,18
2015,醫學中心,Klebsiella pneumoniae,Cefazolin,48298,22211,12113,10098,17
2015,醫學中心,Klebsiella pneumoniae,Ceftriaxone,48298,13002,9677,3325,17
2015,醫學中心,Klebsiella pneumoniae,Ertapenem,48298,41849,37755,4094,22
2015,醫學中心,Klebsiella pneumoniae,Gentamicin,48298,32090,24076,8014,17
2015,醫學中心,Klebsiella pneumoniae,Imipenem,48298,35558,33097,2461,23
2015,醫學中心,Klebsiella pneumoniae,Levofloxacin,48298,23202,17225,5977,17
2015,醫學中心,Klebsiella pneumoniae,Meropenem,48298,18715,18001,714,22
2015,醫學中心,Proteus mirabilis,Ampicillin/Sulbactam,9724,7240,5031,2209,17
2015,醫學中心,Proteus mirabilis,Ampicillin,9724,4900,2035,2865,17
2015,醫學中心,Proteus mirabilis,Amikacin,9724,7465,7241,224,17
2015,醫學中心,Proteus mirabilis,Cefuroxime sodium,9724,1681,1472,209,17
2015,醫學中心,Proteus mirabilis,Cefotaxime,9724,4130,3701,429,17
2015,醫學中心,Proteus mirabilis,Ciprofloxacin,9724,6715,4734,1981,17
2015,醫學中心,Proteus mirabilis,Cefazolin,9724,8634,4519,4115,17
2015,醫學中心,Proteus mirabilis,Ceftriaxone,9724,3772,3331,441,17
2015,醫學中心,Proteus mirabilis,Gentamicin,9724,9043,6123,2920,17
2015,醫學中心,Proteus mirabilis,Levofloxacin,9724,6134,4696,1438,17
2015,醫學中心,Proteus mirabilis,Meropenem,9724,2734,2632,102,17
2015,醫學中心,Pseudomonas aeruginosa,Amikacin,34961,24020,23307,713,17
2015,醫學中心,Pseudomonas aeruginosa,Cefepime,34961,22748,19407,3341,17
2015,醫學中心,Pseudomonas aeruginosa,Ciprofloxacin,34961,30587,24395,6192,17
2015,醫學中心,Pseudomonas aeruginosa,Ceftazidime,34961,31600,26938,4662,18
2015,醫學中心,Pseudomonas aeruginosa,Gentamicin,34961,29823,26258,3565,17
2015,醫學中心,Pseudomonas aeruginosa,Imipenem,34961,30662,25247,5415,17
2015,醫學中心,Pseudomonas aeruginosa,Levofloxacin,34961,28478,21589,6889,17
2015,醫學中心,Pseudomonas aeruginosa,Meropenem,34961,22664,19632,3032,18
2015,醫學中心,Pseudomonas aeruginosa,Piperacillin/Tazobactam,34961,29541,24699,4842,17
2015,醫學中心,Pseudomonas aeruginosa,Piperacillin,34961,9471,7655,1816,17
2015,醫學中心,Enterococcus faecalis,Ampicillin,20714,10668,9743,925,17
2015,醫學中心,Enterococcus faecalis,Gentamicin-High,20714,10392,5330,5062,17
2015,醫學中心,Enterococcus faecalis,Vancomycin,20714,20656,20546,110,23
2015,醫學中心,Enterococcus faecium,Ampicillin,13458,6442,545,5897,17
2015,醫學中心,Enterococcus faecium,Gentamicin-High,13458,7318,3041,4277,17
2015,醫學中心,Enterococcus faecium,Vancomycin,13458,13442,5926,7516,23
2015,醫學中心,Staphylococcus aureus,Ciprofloxacin,47035,15020,11079,3941,17
2015,醫學中心,Staphylococcus aureus,Oxacillin,47035,46349,22961,23388,23
2015,醫學中心,Staphylococcus aureus,Trimethoprim/Sulfamethoxazole,47035,30732,25648,5084,17
2015,醫學中心,Staphylococcus aureus,Vancomycin,47035,31424,31408,16,18
2015,醫學中心,Enterococcus spp.,Ampicillin,6288,5307,4048,1259,17
2015,醫學中心,Enterococcus spp.,Gentamicin-High,6288,5440,3718,1722,17
2015,醫學中心,Enterococcus spp.,Vancomycin,6288,6263,5637,626,22
2015,區域醫院,Acinetobacter baumannii,Ampicillin/Sulbactam,26496,20426,8748,11678,73
2015,區域醫院,Acinetobacter baumannii,Amikacin,26496,15589,6474,9115,73
2015,區域醫院,Acinetobacter baumannii,Cefepime,26496,20136,6112,14024,73
2015,區域醫院,Acinetobacter baumannii,Ciprofloxacin,26496,14706,4272,10434,73
2015,區域醫院,Acinetobacter baumannii,Ceftazidime,26496,21454,6137,15317,73
2015,區域醫院,Acinetobacter baumannii,Colistin,26496,8190,8025,165,72
2015,區域醫院,Acinetobacter baumannii,Gentamicin,26496,21409,6623,14786,73
2015,區域醫院,Acinetobacter baumannii,Imipenem,26496,21034,7646,13388,80
2015,區域醫院,Acinetobacter baumannii,Levofloxacin,26496,16856,5086,11770,73
2015,區域醫院,Acinetobacter baumannii,Meropenem,26496,14790,5954,8836,79
2015,區域醫院,Acinetobacter baumannii,Piperacillin/Tazobactam,26496,20718,5416,15302,73
2015,區域醫院,Acinetobacter baumannii,Piperacillin,26496,5977,823,5154,72
2015,區域醫院,Acinetobacter baumannii,Tigecycline,26496,11732,8587,3145,72
2015,區域醫院,Enterobacter cloacae,Amikacin,9455,7871,7639,232,70
2015,區域醫院,Enterobacter cloacae,Cefotaxime,9455,3669,2281,1388,70
2015,區域醫院,Enterobacter cloacae,Cefepime,9455,7538,6879,659,70
2015,區域醫院,Enterobacter cloacae,Ciprofloxacin,9455,5648,4702,946,70
2015,區域醫院,Enterobacter cloacae,Ceftazidime,9455,6913,4901,2012,71
2015,區域醫院,Enterobacter cloacae,Ceftriaxone,9455,7109,4848,2261,71
2015,區域醫院,Enterobacter cloacae,Ertapenem,9455,7317,6525,792,73
2015,區域醫院,Enterobacter cloacae,Gentamicin,9455,8269,7150,1119,70
2015,區域醫院,Enterobacter cloacae,Imipenem,9455,5608,5162,446,72
2015,區域醫院,Enterobacter cloacae,Levofloxacin,9455,6296,5578,718,70
2015,區域醫院,Enterobacter cloacae,Meropenem,9455,4581,4487,94,72
2015,區域醫院,Escherichia coli,Ampicillin/Sulbactam,133299,104773,52185,52588,70
2015,區域醫院,Escherichia coli,Ampicillin,133299,62909,16167,46742,70
2015,區域醫院,Escherichia coli,Amikacin,133299,119610,117484,2126,71
2015,區域醫院,Escherichia coli,Cefuroxime sodium,133299,35804,24252,11552,70
2015,區域醫院,Escherichia coli,Cefotaxime,133299,52171,35464,16707,70
2015,區域醫院,Escherichia coli,Ciprofloxacin,133299,88557,56257,32300,71
2015,區域醫院,Escherichia coli,Ceftazidime,133299,88408,67520,20888,71
2015,區域醫院,Escherichia coli,Cefazolin,133299,108218,58259,49959,70
2015,區域醫院,Escherichia coli,Ceftriaxone,133299,95451,66806,28645,71
2015,區域醫院,Escherichia coli,Ertapenem,133299,100408,98452,1956,73
2015,區域醫院,Escherichia coli,Gentamicin,133299,125537,93517,32020,71
2015,區域醫院,Escherichia coli,Imipenem,133299,79427,77566,1861,74
2015,區域醫院,Escherichia coli,Levofloxacin,133299,97951,62604,35347,71
2015,區域醫院,Escherichia coli,Meropenem,133299,56994,56408,586,73
2015,區域醫院,Klebsiella pneumoniae,Ampicillin/Sulbactam,58574,40516,23728,16788,72
2015,區域醫院,Klebsiella pneumoniae,Ampicillin,58574,22614,623,21991,72
2015,區域醫院,Klebsiella pneumoniae,Amikacin,58574,47763,44454,3309,73
2015,區域醫院,Klebsiella pneumoniae,Cefuroxime sodium,58574,12199,7466,4733,72
2015,區域醫院,Klebsiella pneumoniae,Cefotaxime,58574,21802,12951,8851,72
2015,區域醫院,Klebsiella pneumoniae,Ciprofloxacin,58574,37457,25978,11479,73
2015,區域醫院,Klebsiella pneumoniae,Ceftazidime,58574,37869,26549,11320,73
2015,區域醫院,Klebsiella pneumoniae,Cefazolin,58574,43574,23637,19937,72
2015,區域醫院,Klebsiella pneumoniae,Ceftriaxone,58574,33578,24748,8830,72
2015,區域醫院,Klebsiella pneumoniae,Ertapenem,58574,39717,34843,4874,77
2015,區域醫院,Klebsiella pneumoniae,Gentamicin,58574,50654,37570,13084,73
2015,區域醫院,Klebsiella pneumoniae,Imipenem,58574,37034,34269,2765,80
2015,區域醫院,Klebsiella pneumoniae,Levofloxacin,58574,33769,24837,8932,72
2015,區域醫院,Klebsiella pneumoniae,Meropenem,58574,24351,23182,1169,79
2015,區域醫院,Proteus mirabilis,Ampicillin/Sulbactam,20429,17261,10907,6354,71
2015,區域醫院,Proteus mirabilis,Ampicillin,20429,11065,3256,7809,70
2015,區域醫院,Proteus mirabilis,Amikacin,20429,15926,14662,1264,70
2015,區域醫院,Proteus mirabilis,Cefuroxime sodium,20429,5167,4019,1148,70
2015,區域醫院,Proteus mirabilis,Cefotaxime,20429,8903,6752,2151,70
2015,區域醫院,Proteus mirabilis,Ciprofloxacin,20429,12937,8305,4632,70
2015,區域醫院,Proteus mirabilis,Cefazolin,20429,18567,7839,10728,71
2015,區域醫院,Proteus mirabilis,Ceftriaxone,20429,12434,10690,1744,70
2015,區域醫院,Proteus mirabilis,Gentamicin,20429,19298,11197,8101,71
2015,區域醫院,Proteus mirabilis,Levofloxacin,20429,12572,8910,3662,70
2015,區域醫院,Proteus mirabilis,Meropenem,20429,8606,8457,149,72
2015,區域醫院,Pseudomonas aeruginosa,Amikacin,51317,41128,39170,1958,70
2015,區域醫院,Pseudomonas aeruginosa,Cefepime,51317,40744,35351,5393,70
2015,區域醫院,Pseudomonas aeruginosa,Ciprofloxacin,51317,36776,26738,10038,71
2015,區域醫院,Pseudomonas aeruginosa,Ceftazidime,51317,47172,41506,5666,71
2015,區域醫院,Pseudomonas aeruginosa,Gentamicin,51317,46969,38699,8270,71
2015,區域醫院,Pseudomonas aeruginosa,Imipenem,51317,38072,32427,5645,73
2015,區域醫院,Pseudomonas aeruginosa,Levofloxacin,51317,40101,28765,11336,71
2015,區域醫院,Pseudomonas aeruginosa,Meropenem,51317,33832,29264,4568,74
2015,區域醫院,Pseudomonas aeruginosa,Piperacillin/Tazobactam,51317,46976,39488,7488,71
2015,區域醫院,Pseudomonas aeruginosa,Piperacillin,51317,18416,13325,5091,71
2015,區域醫院,Enterococcus faecalis,Ampicillin,18996,12392,11520,872,70
2015,區域醫院,Enterococcus faecalis,Gentamicin-High,18996,14150,7215,6935,69
2015,區域醫院,Enterococcus faecalis,Vancomycin,18996,18627,18399,228,77
2015,區域醫院,Enterococcus faecium,Ampicillin,8344,5283,693,4590,70
2015,區域醫院,Enterococcus faecium,Gentamicin-High,8344,6075,2369,3706,69
2015,區域醫院,Enterococcus faecium,Vancomycin,8344,7864,4103,3761,77
2015,區域醫院,Staphylococcus aureus,Ciprofloxacin,52330,15433,8852,6581,72
2015,區域醫院,Staphylococcus aureus,Oxacillin,52330,50602,23432,27170,80
2015,區域醫院,Staphylococcus aureus,Trimethoprim/Sulfamethoxazole,52330,43286,36504,6782,73
2015,區域醫院,Staphylococcus aureus,Vancomycin,52330,41589,41333,256,74
2015,區域醫院,Enterococcus spp.,Ampicillin,12470,9334,7106,2228,68
2015,區域醫院,Enterococcus spp.,Gentamicin-High,12470,9890,5547,4343,67
2015,區域醫院,Enterococcus spp.,Vancomycin,12470,12345,10787,1558,72
2015,地區醫院,Acinetobacter baumannii,Ampicillin/Sulbactam,16022,9390,2890,6500,176
2015,地區醫院,Acinetobacter baumannii,Amikacin,16022,9901,2344,7557,176
2015,地區醫院,Acinetobacter baumannii,Cefepime,16022,8753,1174,7579,176
2015,地區醫院,Acinetobacter baumannii,Ciprofloxacin,16022,9130,886,8244,176
2015,地區醫院,Acinetobacter baumannii,Ceftazidime,16022,11331,2176,9155,176
2015,地區醫院,Acinetobacter baumannii,Colistin,16022,4703,4584,119,174
2015,地區醫院,Acinetobacter baumannii,Gentamicin,16022,11517,2358,9159,176
2015,地區醫院,Acinetobacter baumannii,Imipenem,16022,13580,3540,10040,185
2015,地區醫院,Acinetobacter baumannii,Levofloxacin,16022,8243,795,7448,175
2015,地區醫院,Acinetobacter baumannii,Meropenem,16022,7264,1515,5749,182
2015,地區醫院,Acinetobacter baumannii,Piperacillin/Tazobactam,16022,9612,1327,8285,176
2015,地區醫院,Acinetobacter baumannii,Piperacillin,16022,2094,207,1887,175
2015,地區醫院,Acinetobacter baumannii,Tigecycline,16022,5153,4019,1134,175
2015,地區醫院,Enterobacter cloacae,Amikacin,2654,2229,2125,104,165
2015,地區醫院,Enterobacter cloacae,Cefotaxime,2654,791,587,204,164
2015,地區醫院,Enterobacter cloacae,Cefepime,2654,1456,1316,140,165
2015,地區醫院,Enterobacter cloacae,Ciprofloxacin,2654,1705,1329,376,165
2015,地區醫院,Enterobacter cloacae,Ceftazidime,2654,1917,1551,366,166
2015,地區醫院,Enterobacter cloacae,Ceftriaxone,2654,1773,1315,458,165
2015,地區醫院,Enterobacter cloacae,Ertapenem,2654,1367,1249,118,166
2015,地區醫院,Enterobacter cloacae,Gentamicin,2654,2394,1948,446,165
2015,地區醫院,Enterobacter cloacae,Imipenem,2654,1827,1749,78,166
2015,地區醫院,Enterobacter cloacae,Levofloxacin,2654,1605,1258,347,165
2015,地區醫院,Enterobacter cloacae,Meropenem,2654,987,942,45,165
2015,地區醫院,Escherichia coli,Ampicillin/Sulbactam,56621,28799,12631,16168,169
2015,地區醫院,Escherichia coli,Ampicillin,56621,26582,6500,20082,170
2015,地區醫院,Escherichia coli,Amikacin,56621,43345,41624,1721,171
2015,地區醫院,Escherichia coli,Cefuroxime sodium,56621,10594,5931,4663,169
2015,地區醫院,Escherichia coli,Cefotaxime,56621,16822,10994,5828,169
2015,地區醫院,Escherichia coli,Ciprofloxacin,56621,37959,20150,17809,171
2015,地區醫院,Escherichia coli,Ceftazidime,56621,36477,24333,12144,171
2015,地區醫院,Escherichia coli,Cefazolin,56621,41875,18729,23146,170
2015,地區醫院,Escherichia coli,Ceftriaxone,56621,33842,21271,12571,170
2015,地區醫院,Escherichia coli,Ertapenem,56621,30841,29203,1638,171
2015,地區醫院,Escherichia coli,Gentamicin,56621,48378,32923,15455,171
2015,地區醫院,Escherichia coli,Imipenem,56621,32971,31356,1615,172
2015,地區醫院,Escherichia coli,Levofloxacin,56621,29902,16708,13194,171
2015,地區醫院,Escherichia coli,Meropenem,56621,24952,23567,1385,171
2015,地區醫院,Klebsiella pneumoniae,Ampicillin/Sulbactam,27600,13273,5713,7560,174
2015,地區醫院,Klebsiella pneumoniae,Ampicillin,27600,11248,861,10387,176
2015,地區醫院,Klebsiella pneumoniae,Amikacin,27600,19566,16815,2751,176
2015,地區醫院,Klebsiella pneumoniae,Cefuroxime sodium,27600,5939,2898,3041,174
2015,地區醫院,Klebsiella pneumoniae,Cefotaxime,27600,7435,4410,3025,174
2015,地區醫院,Klebsiella pneumoniae,Ciprofloxacin,27600,16788,9638,7150,176
2015,地區醫院,Klebsiella pneumoniae,Ceftazidime,27600,17582,10280,7302,176
2015,地區醫院,Klebsiella pneumoniae,Cefazolin,27600,18446,8393,10053,174
2015,地區醫院,Klebsiella pneumoniae,Ceftriaxone,27600,14749,9155,5594,174
2015,地區醫院,Klebsiella pneumoniae,Ertapenem,27600,16220,14050,2170,182
2015,地區醫院,Klebsiella pneumoniae,Gentamicin,27600,21726,14359,7367,176
2015,地區醫院,Klebsiella pneumoniae,Imipenem,27600,19783,18085,1698,184
2015,地區醫院,Klebsiella pneumoniae,Levofloxacin,27600,12016,7527,4489,175
2015,地區醫院,Klebsiella pneumoniae,Meropenem,27600,11112,10233,879,181
2015,地區醫院,Proteus mirabilis,Ampicillin/Sulbactam,14614,9486,4130,5356,170
2015,地區醫院,Proteus mirabilis,Ampicillin,14614,7560,1349,6211,170
2015,地區醫院,Proteus mirabilis,Amikacin,14614,12572,9577,2995,170
2015,地區醫院,Proteus mirabilis,Cefuroxime sodium,14614,3148,2010,1138,169
2015,地區醫院,Proteus mirabilis,Cefotaxime,14614,4668,3138,1530,169
2015,地區醫院,Proteus mirabilis,Ciprofloxacin,14614,10472,4959,5513,170
2015,地區醫院,Proteus mirabilis,Cefazolin,14614,10992,3129,7863,171
2015,地區醫院,Proteus mirabilis,Ceftriaxone,14614,9511,6846,2665,169
2015,地區醫院,Proteus mirabilis,Gentamicin,14614,13920,4889,9031,171
2015,地區醫院,Proteus mirabilis,Levofloxacin,14614,8169,4461,3708,170
2015,地區醫院,Proteus mirabilis,Meropenem,14614,7481,6953,528,170
2015,地區醫院,Pseudomonas aeruginosa,Amikacin,28737,24096,22029,2067,170
2015,地區醫院,Pseudomonas aeruginosa,Cefepime,28737,19018,14902,4116,170
2015,地區醫院,Pseudomonas aeruginosa,Ciprofloxacin,28737,21491,10900,10591,171
2015,地區醫院,Pseudomonas aeruginosa,Ceftazidime,28737,25818,20522,5296,171
2015,地區醫院,Pseudomonas aeruginosa,Gentamicin,28737,25510,16755,8755,171
2015,地區醫院,Pseudomonas aeruginosa,Imipenem,28737,21470,16805,4665,171
2015,地區醫院,Pseudomonas aeruginosa,Levofloxacin,28737,19795,9867,9928,171
2015,地區醫院,Pseudomonas aeruginosa,Meropenem,28737,16274,12546,3728,171
2015,地區醫院,Pseudomonas aeruginosa,Piperacillin/Tazobactam,28737,22317,17307,5010,171
2015,地區醫院,Pseudomonas aeruginosa,Piperacillin,28737,8528,6065,2463,171
2015,地區醫院,Enterococcus faecalis,Ampicillin,4322,2797,2543,254,161
2015,地區醫院,Enterococcus faecalis,Gentamicin-High,4322,2640,1141,1499,162
2015,地區醫院,Enterococcus faecalis,Vancomycin,4322,4092,3967,125,168
2015,地區醫院,Enterococcus faecium,Ampicillin,1697,1249,169,1080,158
2015,地區醫院,Enterococcus faecium,Gentamicin-High,1697,1209,409,800,157
2015,地區醫院,Enterococcus faecium,Vancomycin,1697,1614,932,682,164
2015,地區醫院,Staphylococcus aureus,Ciprofloxacin,25202,8664,5485,3179,174
2015,地區醫院,Staphylococcus aureus,Oxacillin,25202,23935,9674,14261,186
2015,地區醫院,Staphylococcus aureus,Trimethoprim/Sulfamethoxazole,25202,16034,13255,2779,176
2015,地區醫院,Staphylococcus aureus,Vancomycin,25202,20425,20186,239,182
2015,地區醫院,Enterococcus spp.,Ampicillin,5990,3067,2303,764,163
2015,地區醫院,Enterococcus spp.,Gentamicin-High,5990,3349,1758,1591,164
2015,地區醫院,Enterococcus spp.,Vancomycin,5990,5931,5213,718,174
2014,醫學中心,Acinetobacter baumannii,Ampicillin/Sulbactam,25641,17602,8977,8625,16
2014,醫學中心,Acinetobacter baumannii,Amikacin,25641,12891,5562,7329,16
2014,醫學中心,Acinetobacter baumannii,Cefepime,25641,17803,7032,10771,16
2014,醫學中心,Acinetobacter baumannii,Ciprofloxacin,25641,17952,6753,11199,16
2014,醫學中心,Acinetobacter baumannii,Ceftazidime,25641,17947,7099,10848,16
2014,醫學中心,Acinetobacter baumannii,Colistin,25641,4453,4406,47,12
2014,醫學中心,Acinetobacter baumannii,Gentamicin,25641,16215,6929,9286,16
2014,醫學中心,Acinetobacter baumannii,Imipenem,25641,24590,9850,14740,22
2014,醫學中心,Acinetobacter baumannii,Levofloxacin,25641,11956,5188,6768,16
2014,醫學中心,Acinetobacter baumannii,Meropenem,25641,15124,6523,8601,21
2014,醫學中心,Acinetobacter baumannii,Piperacillin/Tazobactam,25641,17048,6091,10957,16
2014,醫學中心,Acinetobacter baumannii,Piperacillin,25641,2603,612,1991,12
2014,醫學中心,Acinetobacter baumannii,Tigecycline,25641,7924,6087,1837,12
2014,醫學中心,Enterobacter cloacae,Amikacin,8506,5969,5883,86,13
2014,醫學中心,Enterobacter cloacae,Cefotaxime,8506,3444,2186,1258,16
2014,醫學中心,Enterobacter cloacae,Cefepime,8506,5393,4898,495,13
2014,醫學中心,Enterobacter cloacae,Ciprofloxacin,8506,5444,4549,895,13
2014,醫學中心,Enterobacter cloacae,Ceftazidime,8506,5670,3451,2219,16
2014,醫學中心,Enterobacter cloacae,Ceftriaxone,8506,4920,2810,2110,15
2014,醫學中心,Enterobacter cloacae,Ertapenem,8506,8028,6639,1389,17
2014,醫學中心,Enterobacter cloacae,Gentamicin,8506,5970,5023,947,13
2014,醫學中心,Enterobacter cloacae,Imipenem,8506,5769,5317,452,17
2014,醫學中心,Enterobacter cloacae,Levofloxacin,8506,5145,4374,771,13
2014,醫學中心,Enterobacter cloacae,Meropenem,8506,2480,2408,72,18
2014,醫學中心,Escherichia coli,Ampicillin/Sulbactam,83045,42760,18331,24429,13
2014,醫學中心,Escherichia coli,Ampicillin,83045,41342,10573,30769,13
2014,醫學中心,Escherichia coli,Amikacin,83045,76924,76199,725,16
2014,醫學中心,Escherichia coli,Cefuroxime sodium,83045,16431,10143,6288,13
2014,醫學中心,Escherichia coli,Cefotaxime,83045,31479,22577,8902,16
2014,醫學中心,Escherichia coli,Ciprofloxacin,83045,71862,46115,25747,16
2014,醫學中心,Escherichia coli,Ceftazidime,83045,38714,28562,10152,16
2014,醫學中心,Escherichia coli,Cefazolin,83045,42678,21255,21423,13
2014,醫學中心,Escherichia coli,Ceftriaxone,83045,48162,33542,14620,15
2014,醫學中心,Escherichia coli,Ertapenem,83045,75745,74710,1035,17
2014,醫學中心,Escherichia coli,Gentamicin,83045,76134,56937,19197,16
2014,醫學中心,Escherichia coli,Imipenem,83045,47513,47232,281,17
2014,醫學中心,Escherichia coli,Levofloxacin,83045,66101,43274,22827,16
2014,醫學中心,Escherichia coli,Meropenem,83045,18613,18545,68,17
2014,醫學中心,Klebsiella pneumoniae,Ampicillin/Sulbactam,46876,21176,12794,8382,13
2014,醫學中心,Klebsiella pneumoniae,Ampicillin,46876,21220,14,21206,13
2014,醫學中心,Klebsiella pneumoniae,Amikacin,46876,33402,31547,1855,16
2014,醫學中心,Klebsiella pneumoniae,Cefuroxime sodium,46876,7514,4310,3204,13
2014,醫學中心,Klebsiella pneumoniae,Cefotaxime,46876,15334,11020,4314,16
2014,醫學中心,Klebsiella pneumoniae,Ciprofloxacin,46876,31257,22792,8465,16
2014,醫學中心,Klebsiella pneumoniae,Ceftazidime,46876,22047,15272,6775,16
2014,醫學中心,Klebsiella pneumoniae,Cefazolin,46876,20231,10705,9526,13
2014,醫學中心,Klebsiella pneumoniae,Ceftriaxone,46876,10643,7823,2820,12
2014,醫學中心,Klebsiella pneumoniae,Ertapenem,46876,41894,37635,4259,21
2014,醫學中心,Klebsiella pneumoniae,Gentamicin,46876,33394,25667,7727,16
2014,醫學中心,Klebsiella pneumoniae,Imipenem,46876,30820,28897,1923,22
2014,醫學中心,Klebsiella pneumoniae,Levofloxacin,46876,21670,16370,5300,13
2014,醫學中心,Klebsiella pneumoniae,Meropenem,46876,14391,13781,610,21
2014,醫學中心,Proteus mirabilis,Ampicillin/Sulbactam,10857,7309,5159,2150,16
2014,醫學中心,Proteus mirabilis,Ampicillin,10857,6248,2549,3699,16
2014,醫學中心,Proteus mirabilis,Amikacin,10857,7212,6968,244,13
2014,醫學中心,Proteus mirabilis,Cefuroxime sodium,10857,1873,1619,254,13
2014,醫學中心,Proteus mirabilis,Cefotaxime,10857,4466,4013,453,13
2014,醫學中心,Proteus mirabilis,Ciprofloxacin,10857,6412,4434,1978,13
2014,醫學中心,Proteus mirabilis,Cefazolin,10857,9028,4353,4675,16
2014,醫學中心,Proteus mirabilis,Ceftriaxone,10857,3187,2809,378,12
2014,醫學中心,Proteus mirabilis,Gentamicin,10857,10042,6757,3285,16
2014,醫學中心,Proteus mirabilis,Levofloxacin,10857,6224,4800,1424,13
2014,醫學中心,Proteus mirabilis,Meropenem,10857,2683,2681,2,14
2014,醫學中心,Pseudomonas aeruginosa,Amikacin,34799,22449,21839,610,13
2014,醫學中心,Pseudomonas aeruginosa,Cefepime,34799,21444,18507,2937,13
2014,醫學中心,Pseudomonas aeruginosa,Ciprofloxacin,34799,31585,25288,6297,16
2014,醫學中心,Pseudomonas aeruginosa,Ceftazidime,34799,31588,26992,4596,16
2014,醫學中心,Pseudomonas aeruginosa,Gentamicin,34799,31550,27933,3617,16
2014,醫學中心,Pseudomonas aeruginosa,Imipenem,34799,31046,25999,5047,17
2014,醫學中心,Pseudomonas aeruginosa,Levofloxacin,34799,30830,23699,7131,16
2014,醫學中心,Pseudomonas aeruginosa,Meropenem,34799,24249,20936,3313,18
2014,醫學中心,Pseudomonas aeruginosa,Piperacillin/Tazobactam,34799,31071,25522,5549,16
2014,醫學中心,Pseudomonas aeruginosa,Piperacillin,34799,13319,10530,2789,15
2014,醫學中心,Enterococcus faecalis,Ampicillin,19658,10007,9035,972,16
2014,醫學中心,Enterococcus faecalis,Gentamicin-High,19658,7295,3853,3442,16
2014,醫學中心,Enterococcus faecalis,Vancomycin,19658,19539,19362,177,22
2014,醫學中心,Enterococcus faecium,Ampicillin,12234,6647,512,6135,16
2014,醫學中心,Enterococcus faecium,Gentamicin-High,12234,5277,2113,3164,16
2014,醫學中心,Enterococcus faecium,Vancomycin,12234,12219,6409,5810,22
2014,醫學中心,Staphylococcus aureus,Ciprofloxacin,46918,14124,10422,3702,17
2014,醫學中心,Staphylococcus aureus,Oxacillin,46918,46232,22869,23363,22
2014,醫學中心,Staphylococcus aureus,Trimethoprim/Sulfamethoxazole,46918,31850,26600,5250,16
2014,醫學中心,Staphylococcus aureus,Vancomycin,46918,31363,31344,19,17
2014,醫學中心,Enterococcus spp.,Ampicillin,7999,6759,5031,1728,16
2014,醫學中心,Enterococcus spp.,Gentamicin-High,7999,6691,4006,2685,16
2014,醫學中心,Enterococcus spp.,Vancomycin,7999,7975,7248,727,21
2014,區域醫院,Acinetobacter baumannii,Ampicillin/Sulbactam,28438,22926,8914,14012,72
2014,區域醫院,Acinetobacter baumannii,Amikacin,28438,17742,7134,10608,70
2014,區域醫院,Acinetobacter baumannii,Cefepime,28438,22276,6276,16000,72
2014,區域醫院,Acinetobacter baumannii,Ciprofloxacin,28438,17232,4491,12741,71
2014,區域醫院,Acinetobacter baumannii,Ceftazidime,28438,23251,6743,16508,72
2014,區域醫院,Acinetobacter baumannii,Colistin,28438,8559,8320,239,69
2014,區域醫院,Acinetobacter baumannii,Gentamicin,28438,22859,6636,16223,72
2014,區域醫院,Acinetobacter baumannii,Imipenem,28438,23112,7937,15175,77
2014,區域醫院,Acinetobacter baumannii,Levofloxacin,28438,16672,4743,11929,71
2014,區域醫院,Acinetobacter baumannii,Meropenem,28438,16971,6153,10818,76
2014,區域醫院,Acinetobacter baumannii,Piperacillin/Tazobactam,28438,22230,5763,16467,72
2014,區域醫院,Acinetobacter baumannii,Piperacillin,28438,8267,777,7490,69
2014,區域醫院,Acinetobacter baumannii,Tigecycline,28438,11384,7906,3478,69
2014,區域醫院,Enterobacter cloacae,Amikacin,8775,7078,6886,192,67
2014,區域醫院,Enterobacter cloacae,Cefotaxime,8775,3583,2236,1347,67
2014,區域醫院,Enterobacter cloacae,Cefepime,8775,6934,6170,764,68
2014,區域醫院,Enterobacter cloacae,Ciprofloxacin,8775,5378,4309,1069,67
2014,區域醫院,Enterobacter cloacae,Ceftazidime,8775,6815,4778,2037,67
2014,區域醫院,Enterobacter cloacae,Ceftriaxone,8775,6149,4324,1825,67
2014,區域醫院,Enterobacter cloacae,Ertapenem,8775,6566,5814,752,70
2014,區域醫院,Enterobacter cloacae,Gentamicin,8775,7289,6299,990,68
2014,區域醫院,Enterobacter cloacae,Imipenem,8775,5451,4985,466,70
2014,區域醫院,Enterobacter cloacae,Levofloxacin,8775,5326,4738,588,66
2014,區域醫院,Enterobacter cloacae,Meropenem,8775,4049,3824,225,69
2014,區域醫院,Escherichia coli,Ampicillin/Sulbactam,126051,91682,45250,46432,68
2014,區域醫院,Escherichia coli,Ampicillin,126051,73722,19128,54594,67
2014,區域醫院,Escherichia coli,Amikacin,126051,110906,108001,2905,68
2014,區域醫院,Escherichia coli,Cefuroxime sodium,126051,37589,23413,14176,64
2014,區域醫院,Escherichia coli,Cefotaxime,126051,54652,36125,18527,67
2014,區域醫院,Escherichia coli,Ciprofloxacin,126051,89218,53737,35481,68
2014,區域醫院,Escherichia coli,Ceftazidime,126051,86015,65745,20270,67
2014,區域醫院,Escherichia coli,Cefazolin,126051,101371,54036,47335,67
2014,區域醫院,Escherichia coli,Ceftriaxone,126051,86389,61654,24735,67
2014,區域醫院,Escherichia coli,Ertapenem,126051,93127,88824,4303,70
2014,區域醫院,Escherichia coli,Gentamicin,126051,115484,85362,30122,69
2014,區域醫院,Escherichia coli,Imipenem,126051,80005,76212,3793,71
2014,區域醫院,Escherichia coli,Levofloxacin,126051,82859,54044,28815,67
2014,區域醫院,Escherichia coli,Meropenem,126051,50578,46538,4040,70
2014,區域醫院,Klebsiella pneumoniae,Ampicillin/Sulbactam,60018,39187,22417,16770,71
2014,區域醫院,Klebsiella pneumoniae,Ampicillin,60018,26551,1199,25352,71
2014,區域醫院,Klebsiella pneumoniae,Amikacin,60018,48397,43775,4622,71
2014,區域醫院,Klebsiella pneumoniae,Cefuroxime sodium,60018,15425,9028,6397,67
2014,區域醫院,Klebsiella pneumoniae,Cefotaxime,60018,24602,15383,9219,70
2014,區域醫院,Klebsiella pneumoniae,Ciprofloxacin,60018,40731,26640,14091,71
2014,區域醫院,Klebsiella pneumoniae,Ceftazidime,60018,39562,27451,12111,70
2014,區域醫院,Klebsiella pneumoniae,Cefazolin,60018,43806,24204,19602,70
2014,區域醫院,Klebsiella pneumoniae,Ceftriaxone,60018,30485,22997,7488,69
2014,區域醫院,Klebsiella pneumoniae,Ertapenem,60018,41786,36342,5444,75
2014,區域醫院,Klebsiella pneumoniae,Gentamicin,60018,50389,37103,13286,72
2014,區域醫院,Klebsiella pneumoniae,Imipenem,60018,39711,35796,3915,77
2014,區域醫院,Klebsiella pneumoniae,Levofloxacin,60018,29668,21519,8149,69
2014,區域醫院,Klebsiella pneumoniae,Meropenem,60018,25247,22235,3012,76
2014,區域醫院,Proteus mirabilis,Ampicillin/Sulbactam,20024,16897,10814,6083,69
2014,區域醫院,Proteus mirabilis,Ampicillin,20024,11899,3682,8217,68
2014,區域醫院,Proteus mirabilis,Amikacin,20024,15867,14400,1467,67
2014,區域醫院,Proteus mirabilis,Cefuroxime sodium,20024,6724,5012,1712,64
2014,區域醫院,Proteus mirabilis,Cefotaxime,20024,9740,7396,2344,66
2014,區域醫院,Proteus mirabilis,Ciprofloxacin,20024,13730,8608,5122,67
2014,區域醫院,Proteus mirabilis,Cefazolin,20024,18724,7643,11081,68
2014,區域醫院,Proteus mirabilis,Ceftriaxone,20024,11920,10162,1758,66
2014,區域醫院,Proteus mirabilis,Gentamicin,20024,18777,10764,8013,69
2014,區域醫院,Proteus mirabilis,Levofloxacin,20024,11011,8079,2932,66
2014,區域醫院,Proteus mirabilis,Meropenem,20024,7822,7133,689,65
2014,區域醫院,Pseudomonas aeruginosa,Amikacin,48669,38287,36157,2130,67
2014,區域醫院,Pseudomonas aeruginosa,Cefepime,48669,39731,33490,6241,68
2014,區域醫院,Pseudomonas aeruginosa,Ciprofloxacin,48669,36787,27088,9699,68
2014,區域醫院,Pseudomonas aeruginosa,Ceftazidime,48669,45977,40245,5732,69
2014,區域醫院,Pseudomonas aeruginosa,Gentamicin,48669,45198,37007,8191,69
2014,區域醫院,Pseudomonas aeruginosa,Imipenem,48669,38513,33220,5293,68
2014,區域醫院,Pseudomonas aeruginosa,Levofloxacin,48669,37521,26992,10529,68
2014,區域醫院,Pseudomonas aeruginosa,Meropenem,48669,34329,29437,4892,70
2014,區域醫院,Pseudomonas aeruginosa,Piperacillin/Tazobactam,48669,46102,38812,7290,69
2014,區域醫院,Pseudomonas aeruginosa,Piperacillin,48669,21261,16060,5201,67
2014,區域醫院,Enterococcus faecalis,Ampicillin,16522,10299,9783,516,66
2014,區域醫院,Enterococcus faecalis,Gentamicin-High,16522,11228,5780,5448,67
2014,區域醫院,Enterococcus faecalis,Vancomycin,16522,16308,16192,116,74
2014,區域醫院,Enterococcus faecium,Ampicillin,7659,5062,725,4337,66
2014,區域醫院,Enterococcus faecium,Gentamicin-High,7659,5225,2028,3197,67
2014,區域醫院,Enterococcus faecium,Vancomycin,7659,7601,4620,2981,74
2014,區域醫院,Staphylococcus aureus,Ciprofloxacin,55407,16960,9990,6970,68
2014,區域醫院,Staphylococcus aureus,Oxacillin,55407,54007,25009,28998,79
2014,區域醫院,Staphylococcus aureus,Trimethoprim/Sulfamethoxazole,55407,45918,37456,8462,72
2014,區域醫院,Staphylococcus aureus,Vancomycin,55407,42757,42248,509,74
2014,區域醫院,Enterococcus spp.,Ampicillin,15301,12038,8630,3408,67
2014,區域醫院,Enterococcus spp.,Gentamicin-High,15301,11844,6095,5749,68
2014,區域醫院,Enterococcus spp.,Vancomycin,15301,15270,13601,1669,72
2014,地區醫院,Acinetobacter baumannii,Ampicillin/Sulbactam,16419,9795,3172,6623,165
2014,地區醫院,Acinetobacter baumannii,Amikacin,16419,11049,3327,7722,166
2014,地區醫院,Acinetobacter baumannii,Cefepime,16419,8759,1600,7159,166
2014,地區醫院,Acinetobacter baumannii,Ciprofloxacin,16419,9896,1222,8674,166
2014,地區醫院,Acinetobacter baumannii,Ceftazidime,16419,11951,2573,9378,169
2014,地區醫院,Acinetobacter baumannii,Colistin,16419,2991,2928,63,161
2014,地區醫院,Acinetobacter baumannii,Gentamicin,16419,11502,2392,9110,167
2014,地區醫院,Acinetobacter baumannii,Imipenem,16419,13994,3988,10006,178
2014,地區醫院,Acinetobacter baumannii,Levofloxacin,16419,8465,1083,7382,164
2014,地區醫院,Acinetobacter baumannii,Meropenem,16419,7915,2097,5818,172
2014,地區醫院,Acinetobacter baumannii,Piperacillin/Tazobactam,16419,10320,1541,8779,168
2014,地區醫院,Acinetobacter baumannii,Piperacillin,16419,2125,167,1958,158
2014,地區醫院,Acinetobacter baumannii,Tigecycline,16419,4074,3403,671,161
2014,地區醫院,Enterobacter cloacae,Amikacin,2588,2142,1950,192,156
2014,地區醫院,Enterobacter cloacae,Cefotaxime,2588,651,469,182,152
2014,地區醫院,Enterobacter cloacae,Cefepime,2588,1401,1305,96,155
2014,地區醫院,Enterobacter cloacae,Ciprofloxacin,2588,1641,1245,396,154
2014,地區醫院,Enterobacter cloacae,Ceftazidime,2588,2034,1628,406,159
2014,地區醫院,Enterobacter cloacae,Ceftriaxone,2588,1650,1216,434,159
2014,地區醫院,Enterobacter cloacae,Ertapenem,2588,1196,1128,68,157
2014,地區醫院,Enterobacter cloacae,Gentamicin,2588,2267,1759,508,156
2014,地區醫院,Enterobacter cloacae,Imipenem,2588,2023,1992,31,158
2014,地區醫院,Enterobacter cloacae,Levofloxacin,2588,1433,1127,306,152
2014,地區醫院,Enterobacter cloacae,Meropenem,2588,1053,966,87,159
2014,地區醫院,Escherichia coli,Ampicillin/Sulbactam,53028,26079,11289,14790,155
2014,地區醫院,Escherichia coli,Ampicillin,53028,22738,5426,17312,155
2014,地區醫院,Escherichia coli,Amikacin,53028,42345,40106,2239,161
2014,地區醫院,Escherichia coli,Cefuroxime sodium,53028,11050,6351,4699,152
2014,地區醫院,Escherichia coli,Cefotaxime,53028,13968,9270,4698,154
2014,地區醫院,Escherichia coli,Ciprofloxacin,53028,38279,20631,17648,159
2014,地區醫院,Escherichia coli,Ceftazidime,53028,36545,24515,12030,159
2014,地區醫院,Escherichia coli,Cefazolin,53028,37762,17093,20669,156
2014,地區醫院,Escherichia coli,Ceftriaxone,53028,34897,22504,12393,159
2014,地區醫院,Escherichia coli,Ertapenem,53028,27596,26068,1528,162
2014,地區醫院,Escherichia coli,Gentamicin,53028,47944,32312,15632,161
2014,地區醫院,Escherichia coli,Imipenem,53028,31991,31072,919,162
2014,地區醫院,Escherichia coli,Levofloxacin,53028,29718,16565,13153,156
2014,地區醫院,Escherichia coli,Meropenem,53028,23259,21840,1419,157
2014,地區醫院,Klebsiella pneumoniae,Ampicillin/Sulbactam,27150,11549,5093,6456,160
2014,地區醫院,Klebsiella pneumoniae,Ampicillin,27150,10587,910,9677,161
2014,地區醫院,Klebsiella pneumoniae,Amikacin,27150,19639,16814,2825,166
2014,地區醫院,Klebsiella pneumoniae,Cefuroxime sodium,27150,5520,2413,3107,158
2014,地區醫院,Klebsiella pneumoniae,Cefotaxime,27150,6239,3569,2670,159
2014,地區醫院,Klebsiella pneumoniae,Ciprofloxacin,27150,16464,9278,7186,165
2014,地區醫院,Klebsiella pneumoniae,Ceftazidime,27150,18101,10635,7466,165
2014,地區醫院,Klebsiella pneumoniae,Cefazolin,27150,16699,7722,8977,162
2014,地區醫院,Klebsiella pneumoniae,Ceftriaxone,27150,13169,8306,4863,161
2014,地區醫院,Klebsiella pneumoniae,Ertapenem,27150,15219,13440,1779,174
2014,地區醫院,Klebsiella pneumoniae,Gentamicin,27150,21485,14149,7336,166
2014,地區醫院,Klebsiella pneumoniae,Imipenem,27150,20433,19267,1166,175
2014,地區醫院,Klebsiella pneumoniae,Levofloxacin,27150,11676,7362,4314,157
2014,地區醫院,Klebsiella pneumoniae,Meropenem,27150,10957,9994,963,169
2014,地區醫院,Proteus mirabilis,Ampicillin/Sulbactam,14830,8617,3673,4944,158
2014,地區醫院,Proteus mirabilis,Ampicillin,14830,7245,1312,5933,158
2014,地區醫院,Proteus mirabilis,Amikacin,14830,11640,8957,2683,158
2014,地區醫院,Proteus mirabilis,Cefuroxime sodium,14830,2656,1637,1019,152
2014,地區醫院,Proteus mirabilis,Cefotaxime,14830,3888,2494,1394,151
2014,地區醫院,Proteus mirabilis,Ciprofloxacin,14830,9421,4759,4662,155
2014,地區醫院,Proteus mirabilis,Cefazolin,14830,10831,3275,7556,160
2014,地區醫院,Proteus mirabilis,Ceftriaxone,14830,8386,5950,2436,156
2014,地區醫院,Proteus mirabilis,Gentamicin,14830,13821,5110,8711,162
2014,地區醫院,Proteus mirabilis,Levofloxacin,14830,7810,4469,3341,152
2014,地區醫院,Proteus mirabilis,Meropenem,14830,7074,6555,519,155
2014,地區醫院,Pseudomonas aeruginosa,Amikacin,27414,22150,20200,1950,157
2014,地區醫院,Pseudomonas aeruginosa,Cefepime,27414,16432,13292,3140,156
2014,地區醫院,Pseudomonas aeruginosa,Ciprofloxacin,27414,21880,11587,10293,161
2014,地區醫院,Pseudomonas aeruginosa,Ceftazidime,27414,26309,21280,5029,162
2014,地區醫院,Pseudomonas aeruginosa,Gentamicin,27414,25437,16595,8842,161
2014,地區醫院,Pseudomonas aeruginosa,Imipenem,27414,21635,17100,4535,159
2014,地區醫院,Pseudomonas aeruginosa,Levofloxacin,27414,20192,10020,10172,159
2014,地區醫院,Pseudomonas aeruginosa,Meropenem,27414,16480,12816,3664,159
2014,地區醫院,Pseudomonas aeruginosa,Piperacillin/Tazobactam,27414,24109,19134,4975,161
2014,地區醫院,Pseudomonas aeruginosa,Piperacillin,27414,8928,6653,2275,158
2014,地區醫院,Enterococcus faecalis,Ampicillin,3405,2408,2194,214,156
2014,地區醫院,Enterococcus faecalis,Gentamicin-High,3405,2172,940,1232,156
2014,地區醫院,Enterococcus faecalis,Vancomycin,3405,3312,3263,49,164
2014,地區醫院,Enterococcus faecium,Ampicillin,1572,1195,150,1045,153
2014,地區醫院,Enterococcus faecium,Gentamicin-High,1572,1058,302,756,153
2014,地區醫院,Enterococcus faecium,Vancomycin,1572,1542,1079,463,162
2014,地區醫院,Staphylococcus aureus,Ciprofloxacin,24346,7767,4929,2838,168
2014,地區醫院,Staphylococcus aureus,Oxacillin,24346,23109,9501,13608,182
2014,地區醫院,Staphylococcus aureus,Trimethoprim/Sulfamethoxazole,24346,14609,12163,2446,169
2014,地區醫院,Staphylococcus aureus,Vancomycin,24346,20391,19885,506,175
2014,地區醫院,Enterococcus spp.,Ampicillin,6308,3239,2453,786,162
2014,地區醫院,Enterococcus spp.,Gentamicin-High,6308,3082,1297,1785,162
2014,地區醫院,Enterococcus spp.,Vancomycin,6308,6290,5689,601,176
2013,醫學中心,Acinetobacter baumannii,Ampicillin/Sulbactam,25310,17892,8625,9267,16
2013,醫學中心,Acinetobacter baumannii,Amikacin,25310,13985,5734,8251,15
2013,醫學中心,Acinetobacter baumannii,Cefepime,25310,18027,6913,11114,16
2013,醫學中心,Acinetobacter baumannii,Ciprofloxacin,25310,17917,6418,11499,16
2013,醫學中心,Acinetobacter baumannii,Ceftazidime,25310,18243,7319,10924,16
2013,醫學中心,Acinetobacter baumannii,Gentamicin,25310,16414,6278,10136,15
2013,醫學中心,Acinetobacter baumannii,Imipenem,25310,23602,9686,13916,21
2013,醫學中心,Acinetobacter baumannii,Levofloxacin,25310,9820,4391,5429,15
2013,醫學中心,Acinetobacter baumannii,Meropenem,25310,14610,5949,8661,20
2013,醫學中心,Acinetobacter baumannii,Piperacillin/Tazobactam,25310,17429,5977,11452,16
2013,醫學中心,Acinetobacter baumannii,Piperacillin,25310,3193,907,2286,11
2013,醫學中心,Enterobacter cloacae,Amikacin,7994,4387,4336,51,12
2013,醫學中心,Enterobacter cloacae,Cefotaxime,7994,3745,2427,1318,15
2013,醫學中心,Enterobacter cloacae,Cefepime,7994,3835,3441,394,12
2013,醫學中心,Enterobacter cloacae,Ciprofloxacin,7994,3804,3119,685,12
2013,醫學中心,Enterobacter cloacae,Ceftazidime,7994,5085,2975,2110,14
2013,醫學中心,Enterobacter cloacae,Ceftriaxone,7994,4451,2589,1862,13
2013,醫學中心,Enterobacter cloacae,Ertapenem,7994,7721,6734,987,15
2013,醫學中心,Enterobacter cloacae,Gentamicin,7994,4340,3622,718,12
2013,醫學中心,Enterobacter cloacae,Imipenem,7994,4768,4403,365,15
2013,醫學中心,Enterobacter cloacae,Levofloxacin,7994,3155,2660,495,11
2013,醫學中心,Enterobacter cloacae,Meropenem,7994,2574,2522,52,15
2013,醫學中心,Escherichia coli,Ampicillin/Sulbactam,74972,32839,14535,18304,11
2013,醫學中心,Escherichia coli,Ampicillin,74972,34727,10239,24488,12
2013,醫學中心,Escherichia coli,Amikacin,74972,74045,73449,596,15
2013,醫學中心,Escherichia coli,Cefuroxime,74972,10994,7263,3731,11
2013,醫學中心,Escherichia coli,Cefotaxime,74972,30613,22895,7718,15
2013,醫學中心,Escherichia coli,Ciprofloxacin,74972,68941,44726,24215,15
2013,醫學中心,Escherichia coli,Ceftazidime,74972,35749,26689,9060,14
2013,醫學中心,Escherichia coli,Cefazolin,74972,35270,20996,14274,12
2013,醫學中心,Escherichia coli,Ceftriaxone,74972,46774,34033,12741,13
2013,醫學中心,Escherichia coli,Ertapenem,74972,71523,70758,765,15
2013,醫學中心,Escherichia coli,Gentamicin,74972,74176,55532,18644,15
2013,醫學中心,Escherichia coli,Imipenem,74972,40749,40528,221,15
2013,醫學中心,Escherichia coli,Levofloxacin,74972,60458,39817,20641,14
2013,醫學中心,Escherichia coli,Meropenem,74972,19682,19604,78,15
2013,醫學中心,Klebsiella pneumoniae,Ampicillin/Sulbactam,47154,15598,9940,5658,11
2013,醫學中心,Klebsiella pneumoniae,Amikacin,47154,31185,29370,1815,15
2013,醫學中心,Klebsiella pneumoniae,Cefuroxime,47154,5169,3301,1868,11
2013,醫學中心,Klebsiella pneumoniae,Cefotaxime,47154,15240,11499,3741,15
2013,醫學中心,Klebsiella pneumoniae,Ciprofloxacin,47154,28807,21092,7715,15
2013,醫學中心,Klebsiella pneumoniae,Ceftazidime,47154,19343,13918,5425,14
2013,醫學中心,Klebsiella pneumoniae,Cefazolin,47154,16361,9714,6647,12
2013,醫學中心,Klebsiella pneumoniae,Ceftriaxone,47154,7175,5774,1401,10
2013,醫學中心,Klebsiella pneumoniae,Ertapenem,47154,39177,36144,3033,20
2013,醫學中心,Klebsiella pneumoniae,Gentamicin,47154,31248,25055,6193,15
2013,醫學中心,Klebsiella pneumoniae,Imipenem,47154,24740,23614,1126,21
2013,醫學中心,Klebsiella pneumoniae,Levofloxacin,47154,15670,12029,3641,11
2013,醫學中心,Klebsiella pneumoniae,Meropenem,47154,13677,13301,376,20
2013,醫學中心,Proteus mirabilis,Ampicillin/Sulbactam,9931,6901,5041,1860,14
2013,醫學中心,Proteus mirabilis,Ampicillin,9931,8149,3334,4815,15
2013,醫學中心,Proteus mirabilis,Amikacin,9931,5728,5536,192,12
2013,醫學中心,Proteus mirabilis,Cefuroxime,9931,1333,1179,154,11
2013,醫學中心,Proteus mirabilis,Cefotaxime,9931,3978,3639,339,12
2013,醫學中心,Proteus mirabilis,Ciprofloxacin,9931,4862,3498,1364,12
2013,醫學中心,Proteus mirabilis,Cefazolin,9931,9265,4925,4340,15
2013,醫學中心,Proteus mirabilis,Ceftriaxone,9931,2206,2035,171,10
2013,醫學中心,Proteus mirabilis,Gentamicin,9931,9735,6451,3284,15
2013,醫學中心,Proteus mirabilis,Levofloxacin,9931,4663,3650,1013,11
2013,醫學中心,Pseudomonas aeruginosa,Amikacin,33648,19058,18444,614,12
2013,醫學中心,Pseudomonas aeruginosa,Cefepime,33648,18188,15564,2624,12
2013,醫學中心,Pseudomonas aeruginosa,Ciprofloxacin,33648,33579,26634,6945,15
2013,醫學中心,Pseudomonas aeruginosa,Ceftazidime,33648,33601,28308,5293,15
2013,醫學中心,Pseudomonas aeruginosa,Gentamicin,33648,32472,28318,4154,15
2013,醫學中心,Pseudomonas aeruginosa,Imipenem,33648,32792,27292,5500,15
2013,醫學中心,Pseudomonas aeruginosa,Levofloxacin,33648,22171,17071,5100,15
2013,醫學中心,Pseudomonas aeruginosa,Meropenem,33648,25046,21746,3300,15
2013,醫學中心,Pseudomonas aeruginosa,Piperacillin/Tazobactam,33648,33323,27820,5503,15
2013,醫學中心,Pseudomonas aeruginosa,Piperacillin,33648,14122,11109,3013,13
2013,醫學中心,Enterococcus faecalis,Ampicillin,16567,9218,8811,407,14
2013,醫學中心,Enterococcus faecalis,Gentamicin-High,16567,4223,2439,1784,15
2013,醫學中心,Enterococcus faecalis,Vancomycin,16567,16537,16472,65,21
2013,醫學中心,Enterococcus faecium,Ampicillin,9377,5366,481,4885,14
2013,醫學中心,Enterococcus faecium,Gentamicin-High,9377,2766,1005,1761,15
2013,醫學中心,Enterococcus faecium,Vancomycin,9377,9245,5398,3847,21
2013,醫學中心,Staphylococcus aureus,Ciprofloxacin,47350,14628,10283,4345,14
2013,醫學中心,Staphylococcus aureus,Oxacillin,47350,46645,22642,24003,21
2013,醫學中心,Staphylococcus aureus,Trimethoprim/Sulfamethoxazole,47350,32011,25606,6405,15
2013,醫學中心,Staphylococcus aureus,Vancomycin,47350,29856,29433,423,16
2013,區域醫院,Acinetobacter baumannii,Ampicillin/Sulbactam,31478,25136,9477,15659,73
2013,區域醫院,Acinetobacter baumannii,Amikacin,31478,21831,8492,13339,73
2013,區域醫院,Acinetobacter baumannii,Cefepime,31478,24207,6773,17434,75
2013,區域醫院,Acinetobacter baumannii,Ciprofloxacin,31478,22178,5635,16543,75
2013,區域醫院,Acinetobacter baumannii,Ceftazidime,31478,26831,7580,19251,75
2013,區域醫院,Acinetobacter baumannii,Gentamicin,31478,25100,7008,18092,75
2013,區域醫院,Acinetobacter baumannii,Imipenem,31478,25067,9035,16032,81
2013,區域醫院,Acinetobacter baumannii,Levofloxacin,31478,18425,4760,13665,73
2013,區域醫院,Acinetobacter baumannii,Meropenem,31478,19744,6874,12870,77
2013,區域醫院,Acinetobacter baumannii,Piperacillin/Tazobactam,31478,26009,6422,19587,75
2013,區域醫院,Acinetobacter baumannii,Piperacillin,31478,7870,767,7103,71
2013,區域醫院,Enterobacter cloacae,Amikacin,9270,5538,5387,151,67
2013,區域醫院,Enterobacter cloacae,Cefotaxime,9270,5099,3346,1753,66
2013,區域醫院,Enterobacter cloacae,Cefepime,9270,5580,5089,491,68
2013,區域醫院,Enterobacter cloacae,Ciprofloxacin,9270,4805,3992,813,66
2013,區域醫院,Enterobacter cloacae,Ceftazidime,9270,6362,4535,1827,68
2013,區域醫院,Enterobacter cloacae,Ceftriaxone,9270,5462,3882,1580,69
2013,區域醫院,Enterobacter cloacae,Ertapenem,9270,6469,5902,567,69
2013,區域醫院,Enterobacter cloacae,Gentamicin,9270,5711,4875,836,68
2013,區域醫院,Enterobacter cloacae,Imipenem,9270,5747,5378,369,68
2013,區域醫院,Enterobacter cloacae,Levofloxacin,9270,3660,3220,440,66
2013,區域醫院,Enterobacter cloacae,Meropenem,9270,3913,3654,259,67
2013,區域醫院,Escherichia coli,Ampicillin/Sulbactam,129199,65926,31825,34101,68
2013,區域醫院,Escherichia coli,Ampicillin,129199,62897,16909,45988,66
2013,區域醫院,Escherichia coli,Amikacin,129199,111146,107729,3417,69
2013,區域醫院,Escherichia coli,Cefuroxime,129199,38174,25835,12339,63
2013,區域醫院,Escherichia coli,Cefotaxime,129199,63820,44857,18963,66
2013,區域醫院,Escherichia coli,Ciprofloxacin,129199,95261,59788,35473,69
2013,區域醫院,Escherichia coli,Ceftazidime,129199,82151,61078,21073,68
2013,區域醫院,Escherichia coli,Cefazolin,129199,82629,45584,37045,67
2013,區域醫院,Escherichia coli,Ceftriaxone,129199,78618,56582,22036,69
2013,區域醫院,Escherichia coli,Ertapenem,129199,87744,84961,2783,69
2013,區域醫院,Escherichia coli,Gentamicin,129199,117807,86447,31360,70
2013,區域醫院,Escherichia coli,Imipenem,129199,74771,71871,2900,70
2013,區域醫院,Escherichia coli,Levofloxacin,129199,76157,50357,25800,68
2013,區域醫院,Escherichia coli,Meropenem,129199,52218,49058,3160,68
2013,區域醫院,Klebsiella pneumoniae,Ampicillin/Sulbactam,64981,33306,19210,14096,71
2013,區域醫院,Klebsiella pneumoniae,Amikacin,64981,52933,46145,6788,73
2013,區域醫院,Klebsiella pneumoniae,Cefuroxime,64981,17403,9458,7945,66
2013,區域醫院,Klebsiella pneumoniae,Cefotaxime,64981,32601,21281,11320,71
2013,區域醫院,Klebsiella pneumoniae,Ciprofloxacin,64981,46535,30881,15654,73
2013,區域醫院,Klebsiella pneumoniae,Ceftazidime,64981,41743,28669,13074,72
2013,區域醫院,Klebsiella pneumoniae,Cefazolin,64981,40033,22916,17117,70
2013,區域醫院,Klebsiella pneumoniae,Ceftriaxone,64981,23321,17914,5407,70
2013,區域醫院,Klebsiella pneumoniae,Ertapenem,64981,40213,36192,4021,79
2013,區域醫院,Klebsiella pneumoniae,Gentamicin,64981,55768,41075,14693,74
2013,區域醫院,Klebsiella pneumoniae,Imipenem,64981,42945,39900,3045,79
2013,區域醫院,Klebsiella pneumoniae,Levofloxacin,64981,22631,15798,6833,69
2013,區域醫院,Klebsiella pneumoniae,Meropenem,64981,25564,23307,2257,77
2013,區域醫院,Proteus mirabilis,Ampicillin/Sulbactam,19654,15375,9822,5553,70
2013,區域醫院,Proteus mirabilis,Ampicillin,19654,13063,4157,8906,69
2013,區域醫院,Proteus mirabilis,Amikacin,19654,12385,11082,1303,66
2013,區域醫院,Proteus mirabilis,Cefuroxime,19654,6473,4691,1782,63
2013,區域醫院,Proteus mirabilis,Cefotaxime,19654,8897,6893,2004,64
2013,區域醫院,Proteus mirabilis,Ciprofloxacin,19654,11807,7739,4068,66
2013,區域醫院,Proteus mirabilis,Cefazolin,19654,18657,8855,9802,69
2013,區域醫院,Proteus mirabilis,Ceftriaxone,19654,8369,7035,1334,67
2013,區域醫院,Proteus mirabilis,Gentamicin,19654,18280,10376,7904,70
2013,區域醫院,Proteus mirabilis,Levofloxacin,19654,7833,5519,2314,66
2013,區域醫院,Pseudomonas aeruginosa,Amikacin,53000,33158,30819,2339,67
2013,區域醫院,Pseudomonas aeruginosa,Cefepime,53000,35416,30456,4960,68
2013,區域醫院,Pseudomonas aeruginosa,Ciprofloxacin,53000,43976,31352,12624,70
2013,區域醫院,Pseudomonas aeruginosa,Ceftazidime,53000,49895,43356,6539,70
2013,區域醫院,Pseudomonas aeruginosa,Gentamicin,53000,47595,37881,9714,70
2013,區域醫院,Pseudomonas aeruginosa,Imipenem,53000,43512,37224,6288,70
2013,區域醫院,Pseudomonas aeruginosa,Levofloxacin,53000,35129,24166,10963,68
2013,區域醫院,Pseudomonas aeruginosa,Meropenem,53000,35488,30415,5073,69
2013,區域醫院,Pseudomonas aeruginosa,Piperacillin/Tazobactam,53000,51163,42585,8578,70
2013,區域醫院,Pseudomonas aeruginosa,Piperacillin,53000,22796,17295,5501,67
2013,區域醫院,Enterococcus faecalis,Ampicillin,14700,10206,9872,334,67
2013,區域醫院,Enterococcus faecalis,Gentamicin-High,14700,10250,5221,5029,68
2013,區域醫院,Enterococcus faecalis,Vancomycin,14700,14620,14466,154,77
2013,區域醫院,Enterococcus faecium,Ampicillin,5899,4284,507,3777,67
2013,區域醫院,Enterococcus faecium,Gentamicin-High,5899,4223,1568,2655,68
2013,區域醫院,Enterococcus faecium,Vancomycin,5899,5904,3961,1943,77
2013,區域醫院,Staphylococcus aureus,Ciprofloxacin,59538,18841,11853,6988,71
2013,區域醫院,Staphylococcus aureus,Oxacillin,59538,59029,27206,31823,83
2013,區域醫院,Staphylococcus aureus,Trimethoprim/Sulfamethoxazole,59538,49209,39912,9297,74
2013,區域醫院,Staphylococcus aureus,Vancomycin,59538,47623,47044,579,75
2012,醫學中心,Acinetobacter baumannii,Ampicillin/Sulbactam,32208,23382,9457,13925,14
2012,醫學中心,Acinetobacter baumannii,Amikacin,32208,18894,8063,10831,13
2012,醫學中心,Acinetobacter baumannii,Cefepime,32208,23427,7589,15838,14
2012,醫學中心,Acinetobacter baumannii,Ciprofloxacin,32208,23602,6901,16701,14
2012,醫學中心,Acinetobacter baumannii,Ceftazidime,32208,23438,8200,15238,14
2012,醫學中心,Acinetobacter baumannii,Gentamicin,32208,18755,5266,13489,13
2012,醫學中心,Acinetobacter baumannii,Imipenem,32208,30347,10370,19977,21
2012,醫學中心,Acinetobacter baumannii,Levofloxacin,32208,13632,4910,8722,13
2012,醫學中心,Acinetobacter baumannii,Meropenem,32208,16501,5015,11486,16
2012,醫學中心,Acinetobacter baumannii,Piperacillin/Tazobactam,32208,23585,6833,16752,14
2012,醫學中心,Enterobacter cloacae,Cefotaxime,8299,3809,2508,1301,13
2012,醫學中心,Enterobacter cloacae,Ceftazidime,8299,4998,2876,2122,12
2012,醫學中心,Enterobacter cloacae,Ceftriaxone,8299,4571,2512,2059,11
2012,醫學中心,Enterobacter cloacae,Ertapenem,8299,7124,6293,831,13
2012,醫學中心,Enterobacter cloacae,Imipenem,8299,3147,3064,83,12
2012,醫學中心,Enterobacter cloacae,Meropenem,8299,1694,1672,22,12
2012,醫學中心,Escherichia coli,Amikacin,70838,62969,62112,857,13
2012,醫學中心,Escherichia coli,Cefotaxime,70838,29571,21848,7723,13
2012,醫學中心,Escherichia coli,Ciprofloxacin,70838,56961,36885,20076,13
2012,醫學中心,Escherichia coli,Ceftazidime,70838,30451,22709,7742,12
2012,醫學中心,Escherichia coli,Ceftriaxone,70838,41971,30825,11146,11
2012,醫學中心,Escherichia coli,Ertapenem,70838,57618,57121,497,13
2012,醫學中心,Escherichia coli,Gentamicin,70838,69751,51584,18167,13
2012,醫學中心,Escherichia coli,Imipenem,70838,26162,26083,79,12
2012,醫學中心,Escherichia coli,Levofloxacin,70838,54949,36832,18117,12
2012,醫學中心,Escherichia coli,Meropenem,70838,14017,13974,43,12
2012,醫學中心,Klebsiella pneumoniae,Amikacin,46683,29138,27380,1758,14
2012,醫學中心,Klebsiella pneumoniae,Cefotaxime,46683,18954,13881,5073,14
2012,醫學中心,Klebsiella pneumoniae,Ciprofloxacin,46683,27341,19491,7850,14
2012,醫學中心,Klebsiella pneumoniae,Ceftazidime,46683,21305,15178,6127,14
2012,醫學中心,Klebsiella pneumoniae,Ertapenem,46683,42009,38842,3167,20
2012,醫學中心,Klebsiella pneumoniae,Gentamicin,46683,33483,26833,6650,14
2012,醫學中心,Klebsiella pneumoniae,Imipenem,46683,22444,21553,891,21
2012,醫學中心,Klebsiella pneumoniae,Meropenem,46683,12074,11831,243,16
2012,醫學中心,Proteus mirabilis,Ampicillin/Sulbactam,9620,5231,3934,1297,13
2012,醫學中心,Proteus mirabilis,Ampicillin,9620,8535,3484,5051,13
2012,醫學中心,Proteus mirabilis,Cefazolin,9620,9605,5321,4284,13
2012,醫學中心,Proteus mirabilis,Gentamicin,9620,9575,6492,3083,13
2012,醫學中心,Pseudomonas aeruginosa,Ciprofloxacin,33580,33537,26619,6918,13
2012,醫學中心,Pseudomonas aeruginosa,Ceftazidime,33580,32805,27547,5258,13
2012,醫學中心,Pseudomonas aeruginosa,Gentamicin,33580,29614,24983,4631,13
2012,醫學中心,Pseudomonas aeruginosa,Imipenem,33580,31989,26844,5145,13
2012,醫學中心,Pseudomonas aeruginosa,Levofloxacin,33580,20511,15827,4684,13
2012,醫學中心,Pseudomonas aeruginosa,Meropenem,33580,23621,20819,2802,13
2012,醫學中心,Pseudomonas aeruginosa,Piperacillin/Tazobactam,33580,33325,28437,4888,13
2012,醫學中心,Pseudomonas aeruginosa,Piperacillin,33580,14458,11701,2757,11
2012,醫學中心,Enterococcus faecalis,Ampicillin,11687,6933,6877,56,14
2012,醫學中心,Enterococcus faecalis,Gentamicin-High,11687,3326,1865,1461,14
2012,醫學中心,Enterococcus faecalis,Vancomycin,11687,12182,12096,86,21
2012,醫學中心,Enterococcus faecium,Ampicillin,7331,4515,397,4118,14
2012,醫學中心,Enterococcus faecium,Gentamicin-High,7331,2907,1128,1779,14
2012,醫學中心,Enterococcus faecium,Vancomycin,7331,7559,3952,3607,21
2012,醫學中心,Staphylococcus aureus,Ciprofloxacin,48110,11617,6977,4640,12
2012,醫學中心,Staphylococcus aureus,Oxacillin,48110,48694,22968,25726,21
2012,醫學中心,Staphylococcus aureus,Trimethoprim/Sulfamethoxazole,48110,36037,28105,7932,14
2012,醫學中心,Staphylococcus aureus,Vancomycin,48110,28232,28219,13,15
2012,區域醫院,Acinetobacter baumannii,Ampicillin/Sulbactam,35263,28001,9852,18149,69
2012,區域醫院,Acinetobacter baumannii,Amikacin,35263,25201,8472,16729,70
2012,區域醫院,Acinetobacter baumannii,Cefepime,35263,25212,6142,19070,70
2012,區域醫院,Acinetobacter baumannii,Ciprofloxacin,35263,26491,5912,20579,70
2012,區域醫院,Acinetobacter baumannii,Ceftazidime,35263,29630,7381,22249,71
2012,區域醫院,Acinetobacter baumannii,Gentamicin,35263,27464,6757,20707,71
2012,區域醫院,Acinetobacter baumannii,Imipenem,35263,27460,9556,17904,81
2012,區域醫院,Acinetobacter baumannii,Levofloxacin,35263,19727,4651,15076,67
2012,區域醫院,Acinetobacter baumannii,Meropenem,35263,17713,6125,11588,74
2012,區域醫院,Acinetobacter baumannii,Piperacillin/Tazobactam,35263,28018,5994,22024,71
2012,區域醫院,Enterobacter cloacae,Cefotaxime,9372,5007,3349,1658,61
2012,區域醫院,Enterobacter cloacae,Ceftazidime,9372,6278,4507,1771,62
2012,區域醫院,Enterobacter cloacae,Ceftriaxone,9372,5201,3719,1482,63
2012,區域醫院,Enterobacter cloacae,Ertapenem,9372,4499,4202,297,66
2012,區域醫院,Enterobacter cloacae,Imipenem,9372,5423,5243,180,62
2012,區域醫院,Enterobacter cloacae,Meropenem,9372,3464,3443,21,60
2012,區域醫院,Escherichia coli,Amikacin,119324,99951,96976,2975,63
2012,區域醫院,Escherichia coli,Cefotaxime,119324,57474,41622,15852,60
2012,區域醫院,Escherichia coli,Ciprofloxacin,119324,91058,58891,32167,63
2012,區域醫院,Escherichia coli,Ceftazidime,119324,74527,55897,18630,61
2012,區域醫院,Escherichia coli,Ceftriaxone,119324,65352,47158,18194,62
2012,區域醫院,Escherichia coli,Ertapenem,119324,57878,56908,970,64
2012,區域醫院,Escherichia coli,Gentamicin,119324,108161,77550,30611,65
2012,區域醫院,Escherichia coli,Imipenem,119324,50732,50463,269,63
2012,區域醫院,Escherichia coli,Levofloxacin,119324,62881,41739,21142,61
2012,區域醫院,Escherichia coli,Meropenem,119324,34752,34606,146,61
2012,區域醫院,Klebsiella pneumoniae,Amikacin,65426,51034,44126,6908,69
2012,區域醫院,Klebsiella pneumoniae,Cefotaxime,65426,30170,20606,9564,66
2012,區域醫院,Klebsiella pneumoniae,Ciprofloxacin,65426,48862,33852,15010,70
2012,區域醫院,Klebsiella pneumoniae,Ceftazidime,65426,40444,28238,12206,67
2012,區域醫院,Klebsiella pneumoniae,Ertapenem,65426,32909,30225,2684,75
2012,區域醫院,Klebsiella pneumoniae,Gentamicin,65426,54185,39242,14943,71
2012,區域醫院,Klebsiella pneumoniae,Imipenem,65426,39353,38052,1301,76
2012,區域醫院,Klebsiella pneumoniae,Meropenem,65426,21707,20408,1299,73
2012,區域醫院,Proteus mirabilis,Ampicillin/Sulbactam,18918,14065,9032,5033,62
2012,區域醫院,Proteus mirabilis,Ampicillin,18918,11990,3592,8398,60
2012,區域醫院,Proteus mirabilis,Cefazolin,18918,17158,7964,9194,63
2012,區域醫院,Proteus mirabilis,Gentamicin,18918,17315,9715,7600,64
2012,區域醫院,Pseudomonas aeruginosa,Ciprofloxacin,50795,45706,33719,11987,64
2012,區域醫院,Pseudomonas aeruginosa,Ceftazidime,50795,49863,42400,7463,65
2012,區域醫院,Pseudomonas aeruginosa,Gentamicin,50795,47973,37843,10130,65
2012,區域醫院,Pseudomonas aeruginosa,Imipenem,50795,44672,38363,6309,66
2012,區域醫院,Pseudomonas aeruginosa,Levofloxacin,50795,34030,23766,10264,61
2012,區域醫院,Pseudomonas aeruginosa,Meropenem,50795,31913,27846,4067,63
2012,區域醫院,Pseudomonas aeruginosa,Piperacillin/Tazobactam,50795,48801,41296,7505,65
2012,區域醫院,Pseudomonas aeruginosa,Piperacillin,50795,24685,20026,4659,61
2012,區域醫院,Enterococcus faecalis,Ampicillin,12891,9365,8962,403,64
2012,區域醫院,Enterococcus faecalis,Gentamicin-High,12891,8160,4280,3880,63
2012,區域醫院,Enterococcus faecalis,Vancomycin,12891,12884,12816,68,74
2012,區域醫院,Enterococcus faecium,Ampicillin,5322,4090,551,3539,64
2012,區域醫院,Enterococcus faecium,Gentamicin-High,5322,3580,1303,2277,63
2012,區域醫院,Enterococcus faecium,Vancomycin,5322,5296,3453,1843,74
2012,區域醫院,Staphylococcus aureus,Ciprofloxacin,59372,17976,11635,6341,65
2012,區域醫院,Staphylococcus aureus,Oxacillin,59372,58891,27993,30898,82
2012,區域醫院,Staphylococcus aureus,Trimethoprim/Sulfamethoxazole,59372,47255,38253,9002,70
2012,區域醫院,Staphylococcus aureus,Vancomycin,59372,47147,47127,20,75
2011,醫學中心,Acinetobacter baumannii,Ampicillin/Sulbactam,34633,25141,11165,13976,14
2011,醫學中心,Acinetobacter baumannii,Amikacin,34633,18297,7786,10511,12
2011,醫學中心,Acinetobacter baumannii,Cefepime,34633,24419,8388,16031,14
2011,醫學中心,Acinetobacter baumannii,Ciprofloxacin,34633,25444,7834,17610,14
2011,醫學中心,Acinetobacter baumannii,Ceftazidime,34633,25333,8782,16551,14
2011,醫學中心,Acinetobacter baumannii,Gentamicin,34633,23494,7083,16411,14
2011,醫學中心,Acinetobacter baumannii,Imipenem,34633,30840,11788,19052,21
2011,醫學中心,Acinetobacter baumannii,Levofloxacin,34633,16307,5833,10474,12
2011,醫學中心,Acinetobacter baumannii,Piperacillin/Tazobactam,34633,23339,6874,16465,14
2011,醫學中心,Enterobacter cloacae,Cefotaxime,8248,3071,1796,1275,10
2011,醫學中心,Enterobacter cloacae,Ceftazidime,8248,5235,2933,2302,10
2011,醫學中心,Enterobacter cloacae,Ceftriaxone,8248,5094,2850,2244,11
2011,醫學中心,Enterobacter cloacae,Imipenem,8248,2960,2837,123,12
2011,醫學中心,Enterobacter cloacae,Meropenem,8248,1285,1187,98,9
2011,醫學中心,Escherichia coli,Amikacin,68156,60795,58758,2037,13
2011,醫學中心,Escherichia coli,Cefotaxime,68156,20321,14832,5489,10
2011,醫學中心,Escherichia coli,Ciprofloxacin,68156,54157,35961,18196,13
2011,醫學中心,Escherichia coli,Ceftazidime,68156,31348,21712,9636,10
2011,醫學中心,Escherichia coli,Ceftriaxone,68156,45252,33196,12056,11
2011,醫學中心,Escherichia coli,Gentamicin,68156,67438,49567,17871,13
2011,醫學中心,Escherichia coli,Levofloxacin,68156,50612,33524,17088,10
2011,醫學中心,Klebsiella pneumoniae,Amikacin,48799,27697,25527,2170,13
2011,醫學中心,Klebsiella pneumoniae,Cefotaxime,48799,15993,11740,4253,11
2011,醫學中心,Klebsiella pneumoniae,Ciprofloxacin,48799,29666,21730,7936,14
2011,醫學中心,Klebsiella pneumoniae,Ceftazidime,48799,23053,16508,6545,11
2011,醫學中心,Klebsiella pneumoniae,Ertapenem,48799,40790,37795,2995,21
2011,醫學中心,Klebsiella pneumoniae,Gentamicin,48799,35736,28909,6827,14
2011,醫學中心,Klebsiella pneumoniae,Imipenem,48799,21516,20724,792,21
2011,醫學中心,Proteus mirabilis,Ampicillin/Sulbactam,10030,4985,3548,1437,12
2011,醫學中心,Proteus mirabilis,Ampicillin,10030,8218,3450,4768,13
2011,醫學中心,Proteus mirabilis,Cefazolin,10030,8967,5102,3865,13
2011,醫學中心,Proteus mirabilis,Gentamicin,10030,9375,6216,3159,13
2011,醫學中心,Pseudomonas aeruginosa,Ciprofloxacin,35889,34972,27699,7273,13
2011,醫學中心,Pseudomonas aeruginosa,Ceftazidime,35889,35803,29765,6038,13
2011,醫學中心,Pseudomonas aeruginosa,Gentamicin,35889,28711,24195,4516,13
2011,醫學中心,Pseudomonas aeruginosa,Imipenem,35889,34864,29088,5776,13
2011,醫學中心,Pseudomonas aeruginosa,Levofloxacin,35889,22629,17508,5121,12
2011,醫學中心,Pseudomonas aeruginosa,Meropenem,35889,23195,19731,3464,11
2011,醫學中心,Pseudomonas aeruginosa,Piperacillin/Tazobactam,35889,35577,29770,5807,13
2011,醫學中心,Pseudomonas aeruginosa,Piperacillin,35889,13652,11133,2519,8
2011,醫學中心,Enterococcus faecalis,Ampicillin,11770,6848,6725,123,13
2011,醫學中心,Enterococcus faecalis,Gentamicin-High,11770,3498,2065,1433,14
2011,醫學中心,Enterococcus faecalis,Vancomycin,11770,11766,11631,135,21
2011,醫學中心,Enterococcus faecium,Ampicillin,7353,4729,443,4286,13
2011,醫學中心,Enterococcus faecium,Gentamicin-High,7353,3010,1124,1886,14
2011,醫學中心,Enterococcus faecium,Vancomycin,7353,7347,4125,3222,21
2011,醫學中心,Staphylococcus aureus,Ciprofloxacin,52339,12396,7565,4831,11
2011,醫學中心,Staphylococcus aureus,Oxacillin,52339,52181,24203,27978,21
2011,醫學中心,Staphylococcus aureus,Trimethoprim/Sulfamethoxazole,52339,37596,29205,8391,14
2011,醫學中心,Staphylococcus aureus,Vancomycin,52339,31969,31955,14,15
2011,區域醫院,Acinetobacter baumannii,Ampicillin/Sulbactam,34927,26707,9085,17622,64
2011,區域醫院,Acinetobacter baumannii,Amikacin,34927,25208,8526,16682,64
2011,區域醫院,Acinetobacter baumannii,Cefepime,34927,24967,5885,19082,66
2011,區域醫院,Acinetobacter baumannii,Ciprofloxacin,34927,25962,5537,20425,67
2011,區域醫院,Acinetobacter baumannii,Ceftazidime,34927,28856,6699,22157,67
2011,區域醫院,Acinetobacter baumannii,Gentamicin,34927,27295,6407,20888,65
2011,區域醫院,Acinetobacter baumannii,Imipenem,34927,31497,11684,19813,82
2011,區域醫院,Acinetobacter baumannii,Levofloxacin,34927,18781,4120,14661,61
2011,區域醫院,Acinetobacter baumannii,Piperacillin/Tazobactam,34927,27364,5828,21536,67
2011,區域醫院,Enterobacter cloacae,Cefotaxime,8364,4283,2771,1512,54
2011,區域醫院,Enterobacter cloacae,Ceftazidime,8364,5412,3886,1526,55
2011,區域醫院,Enterobacter cloacae,Ceftriaxone,8364,5033,3526,1507,58
2011,區域醫院,Enterobacter cloacae,Imipenem,8364,4902,4657,245,58
2011,區域醫院,Enterobacter cloacae,Meropenem,8364,2855,2652,203,52
2011,區域醫院,Escherichia coli,Amikacin,100586,87255,84139,3116,58
2011,區域醫院,Escherichia coli,Cefotaxime,100586,48982,34823,14159,56
2011,區域醫院,Escherichia coli,Ciprofloxacin,100586,79153,51311,27842,60
2011,區域醫院,Escherichia coli,Ceftazidime,100586,59630,46632,12998,57
2011,區域醫院,Escherichia coli,Ceftriaxone,100586,59789,42831,16958,60
2011,區域醫院,Escherichia coli,Gentamicin,100586,94725,67114,27611,59
2011,區域醫院,Escherichia coli,Levofloxacin,100586,54821,35897,18924,56
2011,區域醫院,Klebsiella pneumoniae,Amikacin,60574,47842,40714,7128,64
2011,區域醫院,Klebsiella pneumoniae,Cefotaxime,60574,28219,19465,8754,61
2011,區域醫院,Klebsiella pneumoniae,Ciprofloxacin,60574,46164,31603,14561,66
2011,區域醫院,Klebsiella pneumoniae,Ceftazidime,60574,34664,25129,9535,64
2011,區域醫院,Klebsiella pneumoniae,Ertapenem,60574,28195,25380,2815,74
2011,區域醫院,Klebsiella pneumoniae,Gentamicin,60574,52039,37698,14341,65
2011,區域醫院,Klebsiella pneumoniae,Imipenem,60574,39223,37336,1887,76
2011,區域醫院,Proteus mirabilis,Ampicillin/Sulbactam,18333,12955,7900,5055,58
2011,區域醫院,Proteus mirabilis,Ampicillin,18333,12743,3981,8762,57
2011,區域醫院,Proteus mirabilis,Cefazolin,18333,16395,7666,8729,58
2011,區域醫院,Proteus mirabilis,Gentamicin,18333,17072,8967,8105,57
2011,區域醫院,Pseudomonas aeruginosa,Ciprofloxacin,49688,44429,32284,12145,61
2011,區域醫院,Pseudomonas aeruginosa,Ceftazidime,49688,48151,42126,6025,61
2011,區域醫院,Pseudomonas aeruginosa,Gentamicin,49688,46914,36402,10512,59
2011,區域醫院,Pseudomonas aeruginosa,Imipenem,49688,43814,38106,5708,61
2011,區域醫院,Pseudomonas aeruginosa,Levofloxacin,49688,33141,22929,10212,56
2011,區域醫院,Pseudomonas aeruginosa,Meropenem,49688,28709,24908,3801,55
2011,區域醫院,Pseudomonas aeruginosa,Piperacillin/Tazobactam,49688,44448,38160,6288,61
2011,區域醫院,Pseudomonas aeruginosa,Piperacillin,49688,24592,20110,4482,57
2011,區域醫院,Enterococcus faecalis,Ampicillin,11435,8008,7437,571,57
2011,區域醫院,Enterococcus faecalis,Gentamicin-High,11435,6003,3110,2893,55
2011,區域醫院,Enterococcus faecalis,Vancomycin,11435,11356,11266,90,70
2011,區域醫院,Enterococcus faecium,Ampicillin,4565,3309,479,2830,57
2011,區域醫院,Enterococcus faecium,Gentamicin-High,4565,2584,847,1737,55
2011,區域醫院,Enterococcus faecium,Vancomycin,4565,4550,3056,1494,70
2011,區域醫院,Staphylococcus aureus,Ciprofloxacin,58159,15819,10341,5478,61
2011,區域醫院,Staphylococcus aureus,Oxacillin,58159,57976,27378,30598,82
2011,區域醫院,Staphylococcus aureus,Trimethoprim/Sulfamethoxazole,58159,43405,33949,9456,65
2011,區域醫院,Staphylococcus aureus,Vancomycin,58159,43718,43476,242,69
2010,醫學中心,Acinetobacter baumannii,Ampicillin/Sulbactam,35759,26216,12287,13929,13
2010,醫學中心,Acinetobacter baumannii,Amikacin,35759,18388,7572,10816,11
2010,醫學中心,Acinetobacter baumannii,Cefepime,35759,25025,8864,16161,13
2010,醫學中心,Acinetobacter baumannii,Ciprofloxacin,35759,26487,8176,18311,14
2010,醫學中心,Acinetobacter baumannii,Ceftazidime,35759,26547,8753,17794,14
2010,醫學中心,Acinetobacter baumannii,Gentamicin,35759,25643,7707,17936,14
2010,醫學中心,Acinetobacter baumannii,Imipenem,35759,32451,13283,19168,21
2010,醫學中心,Acinetobacter baumannii,Levofloxacin,35759,16126,5859,10267,10
2010,醫學中心,Acinetobacter baumannii,Piperacillin/Tazobactam,35759,24098,6741,17357,14
2010,醫學中心,Enterobacter cloacae,Cefotaxime,8602,3255,2017,1238,8
2010,醫學中心,Enterobacter cloacae,Ceftazidime,8602,5476,2896,2580,11
2010,醫學中心,Enterobacter cloacae,Ceftriaxone,8602,5377,2950,2427,11
2010,醫學中心,Enterobacter cloacae,Imipenem,8602,2276,2037,239,11
2010,醫學中心,Enterobacter cloacae,Meropenem,8602,1193,1140,53,7
2010,醫學中心,Escherichia coli,Amikacin,64860,60710,58337,2373,12
2010,醫學中心,Escherichia coli,Cefotaxime,64860,20471,14515,5956,8
2010,醫學中心,Escherichia coli,Ciprofloxacin,64860,52764,35023,17741,12
2010,醫學中心,Escherichia coli,Ceftazidime,64860,30393,19291,11102,11
2010,醫學中心,Escherichia coli,Ceftriaxone,64860,43830,31226,12604,11
2010,醫學中心,Escherichia coli,Gentamicin,64860,64291,46467,17824,13
2010,醫學中心,Escherichia coli,Levofloxacin,64860,45134,28887,16247,11
2010,醫學中心,Klebsiella pneumoniae,Amikacin,47434,28435,25461,2974,12
2010,醫學中心,Klebsiella pneumoniae,Cefotaxime,47434,16492,11847,4645,9
2010,醫學中心,Klebsiella pneumoniae,Ciprofloxacin,47434,31326,23034,8292,13
2010,醫學中心,Klebsiella pneumoniae,Ceftazidime,47434,23824,16202,7622,12
2010,醫學中心,Klebsiella pneumoniae,Ertapenem,47434,37667,35999,1668,19
2010,醫學中心,Klebsiella pneumoniae,Gentamicin,47434,35690,27974,7716,14
2010,醫學中心,Klebsiella pneumoniae,Imipenem,47434,20006,18202,1804,18
2010,醫學中心,Proteus mirabilis,Ampicillin/Sulbactam,10063,4385,2961,1424,10
2010,醫學中心,Proteus mirabilis,Ampicillin,10063,8033,3211,4822,12
2010,醫學中心,Proteus mirabilis,Cefazolin,10063,8471,6001,2470,11
2010,醫學中心,Proteus mirabilis,Gentamicin,10063,9773,6204,3569,13
2010,醫學中心,Pseudomonas aeruginosa,Ciprofloxacin,35409,35203,27955,7248,13
2010,醫學中心,Pseudomonas aeruginosa,Ceftazidime,35409,35234,30163,5071,13
2010,醫學中心,Pseudomonas aeruginosa,Gentamicin,35409,30113,24998,5115,13
2010,醫學中心,Pseudomonas aeruginosa,Imipenem,35409,35020,30074,4946,13
2010,醫學中心,Pseudomonas aeruginosa,Levofloxacin,35409,21097,16335,4762,10
2010,醫學中心,Pseudomonas aeruginosa,Meropenem,35409,20148,17629,2519,10
2010,醫學中心,Pseudomonas aeruginosa,Piperacillin/Tazobactam,35409,34333,29330,5003,13
2010,醫學中心,Pseudomonas aeruginosa,Piperacillin,35409,16258,13396,2862,7
2010,醫學中心,Enterococcus faecalis,Ampicillin,9418,5884,5770,114,13
2010,醫學中心,Enterococcus faecalis,Gentamicin-High,9418,2355,1357,998,10
2010,醫學中心,Enterococcus faecalis,Vancomycin,9418,9410,9336,74,19
2010,醫學中心,Enterococcus faecium,Ampicillin,5780,3967,399,3568,13
2010,醫學中心,Enterococcus faecium,Gentamicin-High,5780,2118,744,1374,10
2010,醫學中心,Enterococcus faecium,Vancomycin,5780,5775,3205,2570,19
2010,醫學中心,Staphylococcus aureus,Ciprofloxacin,50890,10142,5253,4889,7
2010,醫學中心,Staphylococcus aureus,Oxacillin,50890,50606,22717,27889,21
2010,醫學中心,Staphylococcus aureus,Trimethoprim/Sulfamethoxazole,50890,37079,27504,9575,13
2010,醫學中心,Staphylococcus aureus,Vancomycin,50890,36484,36464,20,16
2010,區域醫院,Acinetobacter baumannii,Ampicillin/Sulbactam,33674,23888,9127,14761,60
2010,區域醫院,Acinetobacter baumannii,Amikacin,33674,24439,7523,16916,64
2010,區域醫院,Acinetobacter baumannii,Cefepime,33674,21136,5077,16059,61
2010,區域醫院,Acinetobacter baumannii,Ciprofloxacin,33674,21882,4396,17486,63
2010,區域醫院,Acinetobacter baumannii,Ceftazidime,33674,26192,6135,20057,65
2010,區域醫院,Acinetobacter baumannii,Gentamicin,33674,25039,5724,19315,64
2010,區域醫院,Acinetobacter baumannii,Imipenem,33674,30880,12650,18230,80
2010,區域醫院,Acinetobacter baumannii,Levofloxacin,33674,17673,3854,13819,59
2010,區域醫院,Acinetobacter baumannii,Piperacillin/Tazobactam,33674,25219,5729,19490,63
2010,區域醫院,Enterobacter cloacae,Cefotaxime,7418,3916,2451,1465,42
2010,區域醫院,Enterobacter cloacae,Ceftazidime,7418,4502,3101,1401,50
2010,區域醫院,Enterobacter cloacae,Ceftriaxone,7418,4108,2774,1334,49
2010,區域醫院,Enterobacter cloacae,Imipenem,7418,4387,4272,115,47
2010,區域醫院,Enterobacter cloacae,Meropenem,7418,2408,2287,121,39
2010,區域醫院,Escherichia coli,Amikacin,83290,74964,71921,3043,53
2010,區域醫院,Escherichia coli,Cefotaxime,83290,41018,29949,11069,44
2010,區域醫院,Escherichia coli,Ciprofloxacin,83290,62321,40544,21777,51
2010,區域醫院,Escherichia coli,Ceftazidime,83290,45973,35455,10518,51
2010,區域醫院,Escherichia coli,Ceftriaxone,83290,45840,33936,11904,50
2010,區域醫院,Escherichia coli,Gentamicin,83290,79073,55671,23402,56
2010,區域醫院,Escherichia coli,Levofloxacin,83290,45009,30246,14763,52
2010,區域醫院,Klebsiella pneumoniae,Amikacin,51708,41137,35489,5648,60
2010,區域醫院,Klebsiella pneumoniae,Cefotaxime,51708,23743,16850,6893,48
2010,區域醫院,Klebsiella pneumoniae,Ciprofloxacin,51708,36673,25639,11034,58
2010,區域醫院,Klebsiella pneumoniae,Ceftazidime,51708,27381,19720,7661,58
2010,區域醫院,Klebsiella pneumoniae,Ertapenem,51708,23555,22755,800,65
2010,區域醫院,Klebsiella pneumoniae,Gentamicin,51708,42789,31364,11425,63
2010,區域醫院,Klebsiella pneumoniae,Imipenem,51708,33744,32489,1255,71
2010,區域醫院,Proteus mirabilis,Ampicillin/Sulbactam,15107,10325,6572,3753,53
2010,區域醫院,Proteus mirabilis,Ampicillin,15107,10932,3429,7503,52
2010,區域醫院,Proteus mirabilis,Cefazolin,15107,13416,7725,5691,55
2010,區域醫院,Proteus mirabilis,Gentamicin,15107,14185,7466,6719,56
2010,區域醫院,Pseudomonas aeruginosa,Ciprofloxacin,44010,36492,26991,9501,53
2010,區域醫院,Pseudomonas aeruginosa,Ceftazidime,44010,42818,37521,5297,56
2010,區域醫院,Pseudomonas aeruginosa,Gentamicin,44010,41845,32150,9695,54
2010,區域醫院,Pseudomonas aeruginosa,Imipenem,44010,38750,33589,5161,53
2010,區域醫院,Pseudomonas aeruginosa,Levofloxacin,44010,31045,21937,9108,52
2010,區域醫院,Pseudomonas aeruginosa,Meropenem,44010,26336,22349,3987,44
2010,區域醫院,Pseudomonas aeruginosa,Piperacillin/Tazobactam,44010,39589,33811,5778,53
2010,區域醫院,Pseudomonas aeruginosa,Piperacillin,44010,24137,20017,4120,45
2010,區域醫院,Enterococcus faecalis,Ampicillin,8304,6042,5870,172,55
2010,區域醫院,Enterococcus faecalis,Gentamicin-High,8304,4128,2230,1898,50
2010,區域醫院,Enterococcus faecalis,Vancomycin,8304,8328,8248,80,66
2010,區域醫院,Enterococcus faecium,Ampicillin,3240,2354,395,1959,54
2010,區域醫院,Enterococcus faecium,Gentamicin-High,3240,1695,636,1059,50
2010,區域醫院,Enterococcus faecium,Vancomycin,3240,3237,2238,999,65
2010,區域醫院,Staphylococcus aureus,Ciprofloxacin,50213,13150,8119,5031,51
2010,區域醫院,Staphylococcus aureus,Oxacillin,50213,50517,23445,27072,81
2010,區域醫院,Staphylococcus aureus,Trimethoprim/Sulfamethoxazole,50213,35242,26962,8280,61
2010,區域醫院,Staphylococcus aureus,Vancomycin,50213,37362,37355,7,70
