年度,醫院層級,菌種名稱,抗生素名稱,分離菌株總數,通報藥敏試驗菌株總數,敏感性菌株數,非敏感性菌株數,通報藥敏試驗醫院家數
2018,醫學中心,Acinetobacter baumannii,Ampicillin/Sulbactam,18627,10676,5154,5522,16
2018,醫學中心,Acinetobacter baumannii,Amikacin,18627,7976,3273,4703,16
2018,醫學中心,Acinetobacter baumannii,Cefepime,18627,13457,5488,7969,16
2018,醫學中心,Acinetobacter baumannii,Ciprofloxacin,18627,14141,5436,8705,16
2018,醫學中心,Acinetobacter baumannii,Ceftazidime,18627,14126,5555,8571,16
2018,醫學中心,Acinetobacter baumannii,Colistin,18627,7383,7251,132,14
2018,醫學中心,Acinetobacter baumannii,Gentamicin,18627,11709,4680,7029,16
2018,醫學中心,Acinetobacter baumannii,Imipenem,18627,16863,7090,9773,22
2018,醫學中心,Acinetobacter baumannii,Levofloxacin,18627,9422,4101,5321,14
2018,醫學中心,Acinetobacter baumannii,Meropenem,18627,11773,5100,6673,21
2018,醫學中心,Acinetobacter baumannii,Piperacillin/Tazobactam,18627,13716,4845,8871,16
2018,醫學中心,Acinetobacter baumannii,Piperacillin,18627,940,267,673,14
2018,醫學中心,Acinetobacter baumannii,Tigecycline,18627,6898,5100,1798,14
2018,醫學中心,Enterobacter cloacae,Amikacin,7908,5181,5016,165,14
2018,醫學中心,Enterobacter cloacae,Cefotaxime,7908,3093,1664,1429,14
2018,醫學中心,Enterobacter cloacae,Cefepime,7908,5977,4853,1124,14
2018,醫學中心,Enterobacter cloacae,Ciprofloxacin,7908,5733,4487,1246,14
2018,醫學中心,Enterobacter cloacae,Ceftazidime,7908,6016,3415,2601,16
2018,醫學中心,Enterobacter cloacae,Ceftriaxone,7908,4794,2681,2113,16
2018,醫學中心,Enterobacter cloacae,Ertapenem,7908,6764,5547,1217,16
2018,醫學中心,Enterobacter cloacae,Gentamicin,7908,6174,5237,937,14
2018,醫學中心,Enterobacter cloacae,Imipenem,7908,5792,5021,771,16
2018,醫學中心,Enterobacter cloacae,Levofloxacin,7908,4833,3856,977,14
2018,醫學中心,Enterobacter cloacae,Meropenem,7908,2352,2234,118,16
2018,醫學中心,Escherichia coli,Ampicillin/Sulbactam,79105,49394,20574,28820,14
2018,醫學中心,Escherichia coli,Ampicillin,79105,17573,4267,13306,14
2018,醫學中心,Escherichia coli,Amikacin,79105,74302,73714,588,16
2018,醫學中心,Escherichia coli,Cefuroxime sodium,79105,14276,8602,5674,14
2018,醫學中心,Escherichia coli,Cefotaxime,79105,24619,16449,8170,14
2018,醫學中心,Escherichia coli,Ciprofloxacin,79105,74795,45324,29471,16
2018,醫學中心,Escherichia coli,Ceftazidime,79105,40575,28811,11764,16
2018,醫學中心,Escherichia coli,Cefazolin,79105,42791,22177,20614,14
2018,醫學中心,Escherichia coli,Ceftriaxone,79105,48644,31359,17285,16
2018,醫學中心,Escherichia coli,Ertapenem,79105,65303,64328,975,16
2018,醫學中心,Escherichia coli,Gentamicin,79105,76985,58301,18684,16
2018,醫學中心,Escherichia coli,Imipenem,79105,50139,49514,625,16
2018,醫學中心,Escherichia coli,Levofloxacin,79105,65185,40343,24842,16
2018,醫學中心,Escherichia coli,Meropenem,79105,17918,17774,144,16
2018,醫學中心,Klebsiella pneumoniae,Ampicillin/Sulbactam,50699,24957,13658,11299,14
2018,醫學中心,Klebsiella pneumoniae,Ampicillin,50699,10220,2,10218,14
2018,醫學中心,Klebsiella pneumoniae,Amikacin,50699,33230,30453,2777,16
2018,醫學中心,Klebsiella pneumoniae,Cefuroxime sodium,50699,7446,4194,3252,14
2018,醫學中心,Klebsiella pneumoniae,Cefotaxime,50699,14471,9590,4881,14
2018,醫學中心,Klebsiella pneumoniae,Ciprofloxacin,50699,35701,24763,10938,16
2018,醫學中心,Klebsiella pneumoniae,Ceftazidime,50699,26210,15970,10240,16
2018,醫學中心,Klebsiella pneumoniae,Cefazolin,50699,22973,11891,11082,14
2018,醫學中心,Klebsiella pneumoniae,Ceftriaxone,50699,14091,9327,4764,14
2018,醫學中心,Klebsiella pneumoniae,Ertapenem,50699,40798,34892,5906,21
2018,醫學中心,Klebsiella pneumoniae,Gentamicin,50699,37059,25985,11074,16
2018,醫學中心,Klebsiella pneumoniae,Imipenem,50699,36777,31704,5073,22
2018,醫學中心,Klebsiella pneumoniae,Levofloxacin,50699,21263,15355,5908,14
2018,醫學中心,Klebsiella pneumoniae,Meropenem,50699,11451,10551,900,21
2018,醫學中心,Proteus mirabilis,Ampicillin/Sulbactam,10453,8131,5532,2599,16
2018,醫學中心,Proteus mirabilis,Ampicillin,10453,2963,1102,1861,14
2018,醫學中心,Proteus mirabilis,Amikacin,10453,7538,7233,305,14
2018,醫學中心,Proteus mirabilis,Cefuroxime sodium,10453,1704,1509,195,14
2018,醫學中心,Proteus mirabilis,Cefotaxime,10453,3986,3500,486,14
2018,醫學中心,Proteus mirabilis,Ciprofloxacin,10453,7452,5034,2418,14
2018,醫學中心,Proteus mirabilis,Cefazolin,10453,8610,3570,5040,16
2018,醫學中心,Proteus mirabilis,Ceftriaxone,10453,3858,3323,535,14
2018,醫學中心,Proteus mirabilis,Gentamicin,10453,10248,7092,3156,16
2018,醫學中心,Proteus mirabilis,Levofloxacin,10453,5952,4417,1535,14
2018,醫學中心,Proteus mirabilis,Meropenem,10453,3592,3581,11,14
2018,醫學中心,Pseudomonas aeruginosa,Amikacin,33895,22679,22073,606,14
2018,醫學中心,Pseudomonas aeruginosa,Cefepime,33895,21634,18749,2885,14
2018,醫學中心,Pseudomonas aeruginosa,Ciprofloxacin,33895,30282,24561,5721,16
2018,醫學中心,Pseudomonas aeruginosa,Ceftazidime,33895,29381,24811,4570,16
2018,醫學中心,Pseudomonas aeruginosa,Gentamicin,33895,27187,24604,2583,16
2018,醫學中心,Pseudomonas aeruginosa,Imipenem,33895,29174,23871,5303,17
2018,醫學中心,Pseudomonas aeruginosa,Levofloxacin,33895,24900,19009,5891,16
2018,醫學中心,Pseudomonas aeruginosa,Meropenem,33895,24883,21421,3462,17
2018,醫學中心,Pseudomonas aeruginosa,Piperacillin/Tazobactam,33895,29486,23930,5556,16
2018,醫學中心,Pseudomonas aeruginosa,Piperacillin,33895,2518,2020,498,14
2018,醫學中心,Enterococcus faecalis,Ampicillin,23273,12689,12638,51,16
2018,醫學中心,Enterococcus faecalis,Gentamicin-High,23273,14544,8143,6401,16
2018,醫學中心,Enterococcus faecalis,Vancomycin,23273,23208,23052,156,22
2018,醫學中心,Enterococcus faecium,Ampicillin,16033,8408,1210,7198,16
2018,醫學中心,Enterococcus faecium,Gentamicin-High,16033,9662,4925,4737,16
2018,醫學中心,Enterococcus faecium,Vancomycin,16033,16009,7061,8948,22
2018,醫學中心,Staphylococcus aureus,Ciprofloxacin,44946,14588,10359,4229,14
2018,醫學中心,Staphylococcus aureus,Oxacillin,44946,44904,23067,21837,22
2018,醫學中心,Staphylococcus aureus,Trimethoprim/Sulfamethoxazole,44946,31757,27711,4046,16
2018,醫學中心,Staphylococcus aureus,Vancomycin,44946,34024,34001,23,18
2018,醫學中心,Enterococcus spp.,Ampicillin,2343,1684,1262,422,16
2018,醫學中心,Enterococcus spp.,Gentamicin-High,2343,1925,1405,520,16
2018,醫學中心,Enterococcus spp.,Vancomycin,2343,2313,1873,440,21
2018,區域醫院,Acinetobacter baumannii,Ampicillin/Sulbactam,25094,20650,8792,11858,75
2018,區域醫院,Acinetobacter baumannii,Amikacin,25094,14397,6356,8041,75
2018,區域醫院,Acinetobacter baumannii,Cefepime,25094,19141,6832,12309,74
2018,區域醫院,Acinetobacter baumannii,Ciprofloxacin,25094,14776,4582,10194,75
2018,區域醫院,Acinetobacter baumannii,Ceftazidime,25094,20715,6274,14441,75
2018,區域醫院,Acinetobacter baumannii,Colistin,25094,5774,5557,217,75
2018,區域醫院,Acinetobacter baumannii,Gentamicin,25094,20069,6807,13262,75
2018,區域醫院,Acinetobacter baumannii,Imipenem,25094,21115,7508,13607,81
2018,區域醫院,Acinetobacter baumannii,Levofloxacin,25094,14848,4788,10060,75
2018,區域醫院,Acinetobacter baumannii,Meropenem,25094,11861,4463,7398,81
2018,區域醫院,Acinetobacter baumannii,Piperacillin/Tazobactam,25094,19617,5806,13811,75
2018,區域醫院,Acinetobacter baumannii,Piperacillin,25094,3667,546,3121,74
2018,區域醫院,Acinetobacter baumannii,Tigecycline,25094,11057,7937,3120,74
2018,區域醫院,Enterobacter cloacae,Amikacin,9832,8245,8033,212,73
2018,區域醫院,Enterobacter cloacae,Cefotaxime,9832,4004,2359,1645,73
2018,區域醫院,Enterobacter cloacae,Cefepime,9832,7427,6427,1000,72
2018,區域醫院,Enterobacter cloacae,Ciprofloxacin,9832,5601,4464,1137,73
2018,區域醫院,Enterobacter cloacae,Ceftazidime,9832,7378,4784,2594,73
2018,區域醫院,Enterobacter cloacae,Ceftriaxone,9832,6030,3769,2261,73
2018,區域醫院,Enterobacter cloacae,Ertapenem,9832,7886,6859,1027,74
2018,區域醫院,Enterobacter cloacae,Gentamicin,9832,8448,7404,1044,73
2018,區域醫院,Enterobacter cloacae,Imipenem,9832,6410,5734,676,73
2018,區域醫院,Enterobacter cloacae,Levofloxacin,9832,5983,5147,836,73
2018,區域醫院,Enterobacter cloacae,Meropenem,9832,4000,3884,116,74
2018,區域醫院,Escherichia coli,Ampicillin/Sulbactam,180092,114199,49159,65040,73
2018,區域醫院,Escherichia coli,Ampicillin,180092,67656,16238,51418,73
2018,區域醫院,Escherichia coli,Amikacin,180092,139335,137118,2217,73
2018,區域醫院,Escherichia coli,Cefuroxime sodium,180092,41210,25507,15703,73
2018,區域醫院,Escherichia coli,Cefotaxime,180092,62016,39678,22338,73
2018,區域醫院,Escherichia coli,Ciprofloxacin,180092,104709,62022,42687,73
2018,區域醫院,Escherichia coli,Ceftazidime,180092,107473,80274,27199,73
2018,區域醫院,Escherichia coli,Cefazolin,180092,117263,62196,55067,73
2018,區域醫院,Escherichia coli,Ceftriaxone,180092,96348,64037,32311,73
2018,區域醫院,Escherichia coli,Ertapenem,180092,122011,119166,2845,77
2018,區域醫院,Escherichia coli,Gentamicin,180092,141180,104527,36653,73
2018,區域醫院,Escherichia coli,Imipenem,180092,94005,92978,1027,76
2018,區域醫院,Escherichia coli,Levofloxacin,180092,110110,67851,42259,73
2018,區域醫院,Escherichia coli,Meropenem,180092,59544,59111,433,75
2018,區域醫院,Klebsiella pneumoniae,Ampicillin/Sulbactam,69889,48043,26238,21805,75
2018,區域醫院,Klebsiella pneumoniae,Ampicillin,69889,25371,304,25067,75
2018,區域醫院,Klebsiella pneumoniae,Amikacin,69889,59032,55273,3759,75
2018,區域醫院,Klebsiella pneumoniae,Cefuroxime sodium,69889,14996,9151,5845,75
2018,區域醫院,Klebsiella pneumoniae,Cefotaxime,69889,26686,16449,10237,75
2018,區域醫院,Klebsiella pneumoniae,Ciprofloxacin,69889,44544,30359,14185,75
2018,區域醫院,Klebsiella pneumoniae,Ceftazidime,69889,48139,30953,17186,75
2018,區域醫院,Klebsiella pneumoniae,Cefazolin,69889,51048,26234,24814,75
2018,區域醫院,Klebsiella pneumoniae,Ceftriaxone,69889,32606,23009,9597,75
2018,區域醫院,Klebsiella pneumoniae,Ertapenem,69889,51702,44281,7421,80
2018,區域醫院,Klebsiella pneumoniae,Gentamicin,69889,60239,43204,17035,75
2018,區域醫院,Klebsiella pneumoniae,Imipenem,69889,46098,40439,5659,81
2018,區域醫院,Klebsiella pneumoniae,Levofloxacin,69889,41101,30306,10795,75
2018,區域醫院,Klebsiella pneumoniae,Meropenem,69889,29878,26965,2913,81
2018,區域醫院,Proteus mirabilis,Ampicillin/Sulbactam,23036,19679,11677,8002,73
2018,區域醫院,Proteus mirabilis,Ampicillin,23036,10260,3826,6434,73
2018,區域醫院,Proteus mirabilis,Amikacin,23036,19759,17831,1928,73
2018,區域醫院,Proteus mirabilis,Cefuroxime sodium,23036,5958,4606,1352,73
2018,區域醫院,Proteus mirabilis,Cefotaxime,23036,9975,7359,2616,73
2018,區域醫院,Proteus mirabilis,Ciprofloxacin,23036,14869,8687,6182,73
2018,區域醫院,Proteus mirabilis,Cefazolin,23036,20059,8116,11943,73
2018,區域醫院,Proteus mirabilis,Ceftriaxone,23036,11673,9633,2040,73
2018,區域醫院,Proteus mirabilis,Gentamicin,23036,22030,12857,9173,73
2018,區域醫院,Proteus mirabilis,Levofloxacin,23036,12584,8661,3923,73
2018,區域醫院,Proteus mirabilis,Meropenem,23036,10358,10032,326,74
2018,區域醫院,Pseudomonas aeruginosa,Amikacin,53944,41234,39356,1878,73
2018,區域醫院,Pseudomonas aeruginosa,Cefepime,53944,38515,33709,4806,72
2018,區域醫院,Pseudomonas aeruginosa,Ciprofloxacin,53944,41341,31223,10118,73
2018,區域醫院,Pseudomonas aeruginosa,Ceftazidime,53944,48404,41276,7128,73
2018,區域醫院,Pseudomonas aeruginosa,Gentamicin,53944,47241,39610,7631,73
2018,區域醫院,Pseudomonas aeruginosa,Imipenem,53944,41739,35505,6234,75
2018,區域醫院,Pseudomonas aeruginosa,Levofloxacin,53944,41596,29994,11602,73
2018,區域醫院,Pseudomonas aeruginosa,Meropenem,53944,32075,27661,4414,77
2018,區域醫院,Pseudomonas aeruginosa,Piperacillin/Tazobactam,53944,45481,37428,8053,73
2018,區域醫院,Pseudomonas aeruginosa,Piperacillin,53944,9064,7135,1929,72
2018,區域醫院,Enterococcus faecalis,Ampicillin,23857,16000,15708,292,74
2018,區域醫院,Enterococcus faecalis,Gentamicin-High,23857,19799,10371,9428,74
2018,區域醫院,Enterococcus faecalis,Vancomycin,23857,23197,22932,265,81
2018,區域醫院,Enterococcus faecium,Ampicillin,14311,10538,905,9633,74
2018,區域醫院,Enterococcus faecium,Gentamicin-High,14311,12150,5376,6774,74
2018,區域醫院,Enterococcus faecium,Vancomycin,14311,14213,5764,8449,81
2018,區域醫院,Staphylococcus aureus,Ciprofloxacin,58275,18046,10980,7066,75
2018,區域醫院,Staphylococcus aureus,Oxacillin,58275,56221,25628,30593,82
2018,區域醫院,Staphylococcus aureus,Trimethoprim/Sulfamethoxazole,58275,51870,44819,7051,75
2018,區域醫院,Staphylococcus aureus,Vancomycin,58275,49620,49228,392,76
2018,區域醫院,Enterococcus spp.,Ampicillin,8636,6740,4920,1820,71
2018,區域醫院,Enterococcus spp.,Gentamicin-High,8636,6641,4044,2597,71
2018,區域醫院,Enterococcus spp.,Vancomycin,8636,8624,7133,1491,75
2018,地區醫院,Acinetobacter baumannii,Ampicillin/Sulbactam,13494,8936,3295,5641,204
2018,地區醫院,Acinetobacter baumannii,Amikacin,13494,8129,2508,5621,204
2018,地區醫院,Acinetobacter baumannii,Cefepime,13494,8810,1597,7213,201
2018,地區醫院,Acinetobacter baumannii,Ciprofloxacin,13494,8116,1255,6861,203
2018,地區醫院,Acinetobacter baumannii,Ceftazidime,13494,10252,1921,8331,204
2018,地區醫院,Acinetobacter baumannii,Colistin,13494,3476,3263,213,199
2018,地區醫院,Acinetobacter baumannii,Gentamicin,13494,9886,2079,7807,204
2018,地區醫院,Acinetobacter baumannii,Imipenem,13494,10575,2727,7848,213
2018,地區醫院,Acinetobacter baumannii,Levofloxacin,13494,8094,1170,6924,201
2018,地區醫院,Acinetobacter baumannii,Meropenem,13494,6962,1766,5196,211
2018,地區醫院,Acinetobacter baumannii,Piperacillin/Tazobactam,13494,9432,1490,7942,203
2018,地區醫院,Acinetobacter baumannii,Piperacillin,13494,1548,214,1334,197
2018,地區醫院,Acinetobacter baumannii,Tigecycline,13494,4251,3303,948,197
2018,地區醫院,Enterobacter cloacae,Amikacin,3139,2652,2484,168,191
2018,地區醫院,Enterobacter cloacae,Cefotaxime,3139,1180,681,499,191
2018,地區醫院,Enterobacter cloacae,Cefepime,3139,2302,1805,497,190
2018,地區醫院,Enterobacter cloacae,Ciprofloxacin,3139,2309,1566,743,191
2018,地區醫院,Enterobacter cloacae,Ceftazidime,3139,2600,1700,900,193
2018,地區醫院,Enterobacter cloacae,Ceftriaxone,3139,2170,1305,865,194
2018,地區醫院,Enterobacter cloacae,Ertapenem,3139,2307,2018,289,193
2018,地區醫院,Enterobacter cloacae,Gentamicin,3139,2979,2378,601,191
2018,地區醫院,Enterobacter cloacae,Imipenem,3139,2333,2127,206,194
2018,地區醫院,Enterobacter cloacae,Levofloxacin,3139,2021,1418,603,191
2018,地區醫院,Enterobacter cloacae,Meropenem,3139,1585,1503,82,191
2018,地區醫院,Escherichia coli,Ampicillin/Sulbactam,66249,41903,17413,24490,197
2018,地區醫院,Escherichia coli,Ampicillin,66249,32314,7485,24829,197
2018,地區醫院,Escherichia coli,Amikacin,66249,55988,53699,2289,202
2018,地區醫院,Escherichia coli,Cefuroxime sodium,66249,18054,10268,7786,194
2018,地區醫院,Escherichia coli,Cefotaxime,66249,21070,12789,8281,197
2018,地區醫院,Escherichia coli,Ciprofloxacin,66249,51472,26057,25415,202
2018,地區醫院,Escherichia coli,Ceftazidime,66249,51687,34521,17166,201
2018,地區醫院,Escherichia coli,Cefazolin,66249,52548,22896,29652,197
2018,地區醫院,Escherichia coli,Ceftriaxone,66249,44472,26103,18369,200
2018,地區醫院,Escherichia coli,Ertapenem,66249,43306,40306,3000,198
2018,地區醫院,Escherichia coli,Gentamicin,66249,63886,44672,19214,202
2018,地區醫院,Escherichia coli,Imipenem,66249,43679,41347,2332,204
2018,地區醫院,Escherichia coli,Levofloxacin,66249,41772,20902,20870,201
2018,地區醫院,Escherichia coli,Meropenem,66249,34755,32026,2729,202
2018,地區醫院,Klebsiella pneumoniae,Ampicillin/Sulbactam,32649,18203,7890,10313,198
2018,地區醫院,Klebsiella pneumoniae,Ampicillin,32649,15804,567,15237,198
2018,地區醫院,Klebsiella pneumoniae,Amikacin,32649,24368,21335,3033,203
2018,地區醫院,Klebsiella pneumoniae,Cefuroxime sodium,32649,7652,3946,3706,195
2018,地區醫院,Klebsiella pneumoniae,Cefotaxime,32649,9101,5302,3799,198
2018,地區醫院,Klebsiella pneumoniae,Ciprofloxacin,32649,22259,13077,9182,203
2018,地區醫院,Klebsiella pneumoniae,Ceftazidime,32649,23494,13947,9547,203
2018,地區醫院,Klebsiella pneumoniae,Cefazolin,32649,23632,10350,13282,198
2018,地區醫院,Klebsiella pneumoniae,Ceftriaxone,32649,18631,11027,7604,198
2018,地區醫院,Klebsiella pneumoniae,Ertapenem,32649,21232,16692,4540,209
2018,地區醫院,Klebsiella pneumoniae,Gentamicin,32649,27630,18499,9131,203
2018,地區醫院,Klebsiella pneumoniae,Imipenem,32649,23551,19511,4040,213
2018,地區醫院,Klebsiella pneumoniae,Levofloxacin,32649,16945,10067,6878,198
2018,地區醫院,Klebsiella pneumoniae,Meropenem,32649,15019,11977,3042,210
2018,地區醫院,Proteus mirabilis,Ampicillin/Sulbactam,16067,11326,5021,6305,197
2018,地區醫院,Proteus mirabilis,Ampicillin,16067,8871,1876,6995,196
2018,地區醫院,Proteus mirabilis,Amikacin,16067,13814,10435,3379,195
2018,地區醫院,Proteus mirabilis,Cefuroxime sodium,16067,3935,2509,1426,191
2018,地區醫院,Proteus mirabilis,Cefotaxime,16067,5372,3490,1882,193
2018,地區醫院,Proteus mirabilis,Ciprofloxacin,16067,12456,5542,6914,195
2018,地區醫院,Proteus mirabilis,Cefazolin,16067,12618,3319,9299,197
2018,地區醫院,Proteus mirabilis,Ceftriaxone,16067,11089,7372,3717,194
2018,地區醫院,Proteus mirabilis,Gentamicin,16067,15261,5694,9567,199
2018,地區醫院,Proteus mirabilis,Levofloxacin,16067,10225,4617,5608,193
2018,地區醫院,Proteus mirabilis,Meropenem,16067,9033,8203,830,193
2018,地區醫院,Pseudomonas aeruginosa,Amikacin,28240,24222,22242,1980,197
2018,地區醫院,Pseudomonas aeruginosa,Cefepime,28240,20695,16635,4060,193
2018,地區醫院,Pseudomonas aeruginosa,Ciprofloxacin,28240,22115,12094,10021,200
2018,地區醫院,Pseudomonas aeruginosa,Ceftazidime,28240,26101,20742,5359,200
2018,地區醫院,Pseudomonas aeruginosa,Gentamicin,28240,26145,17767,8378,200
2018,地區醫院,Pseudomonas aeruginosa,Imipenem,28240,20878,15857,5021,200
2018,地區醫院,Pseudomonas aeruginosa,Levofloxacin,28240,21294,10425,10869,199
2018,地區醫院,Pseudomonas aeruginosa,Meropenem,28240,17098,13070,4028,199
2018,地區醫院,Pseudomonas aeruginosa,Piperacillin/Tazobactam,28240,24377,17939,6438,199
2018,地區醫院,Pseudomonas aeruginosa,Piperacillin,28240,6556,4382,2174,195
2018,地區醫院,Enterococcus faecalis,Ampicillin,5969,4420,4229,191,187
2018,地區醫院,Enterococcus faecalis,Gentamicin-High,5969,4425,1971,2454,186
2018,地區醫院,Enterococcus faecalis,Vancomycin,5969,5923,5711,212,192
2018,地區醫院,Enterococcus faecium,Ampicillin,2761,2143,166,1977,186
2018,地區醫院,Enterococcus faecium,Gentamicin-High,2761,2123,974,1149,185
2018,地區醫院,Enterococcus faecium,Vancomycin,2761,2714,1109,1605,191
2018,地區醫院,Staphylococcus aureus,Ciprofloxacin,26146,10016,5332,4684,203
2018,地區醫院,Staphylococcus aureus,Oxacillin,26146,25109,10075,15034,216
2018,地區醫院,Staphylococcus aureus,Trimethoprim/Sulfamethoxazole,26146,19784,16872,2912,207
2018,地區醫院,Staphylococcus aureus,Vancomycin,26146,23211,22865,346,213
2018,地區醫院,Enterococcus spp.,Ampicillin,6918,3601,2625,976,195
2018,地區醫院,Enterococcus spp.,Gentamicin-High,6918,3707,1712,1995,195
2018,地區醫院,Enterococcus spp.,Vancomycin,6918,6782,5684,1098,206
2017,醫學中心,Acinetobacter baumannii,Ampicillin/Sulbactam,18299,9981,5165,4816,16
2017,醫學中心,Acinetobacter baumannii,Amikacin,18299,8999,4367,4632,16
2017,醫學中心,Acinetobacter baumannii,Cefepime,18299,11869,5055,6814,16
2017,醫學中心,Acinetobacter baumannii,Ciprofloxacin,18299,13494,5241,8253,16
2017,醫學中心,Acinetobacter baumannii,Ceftazidime,18299,12611,5277,7334,16
2017,醫學中心,Acinetobacter baumannii,Colistin,18299,7619,7500,119,14
2017,醫學中心,Acinetobacter baumannii,Gentamicin,18299,10422,4229,6193,16
2017,醫學中心,Acinetobacter baumannii,Imipenem,18299,15969,7258,8711,22
2017,醫學中心,Acinetobacter baumannii,Levofloxacin,18299,8689,3653,5036,15
2017,醫學中心,Acinetobacter baumannii,Meropenem,18299,11876,5120,6756,21
2017,醫學中心,Acinetobacter baumannii,Piperacillin/Tazobactam,18299,13006,4889,8117,16
2017,醫學中心,Acinetobacter baumannii,Piperacillin,18299,943,304,639,14
2017,醫學中心,Acinetobacter baumannii,Tigecycline,18299,5966,4595,1371,14
2017,醫學中心,Enterobacter cloacae,Amikacin,7261,5434,5333,101,14
2017,醫學中心,Enterobacter cloacae,Cefotaxime,7261,2810,1579,1231,15
2017,醫學中心,Enterobacter cloacae,Cefepime,7261,5325,4433,892,14
2017,醫學中心,Enterobacter cloacae,Ciprofloxacin,7261,5511,4289,1222,14
2017,醫學中心,Enterobacter cloacae,Ceftazidime,7261,5239,2875,2364,16
2017,醫學中心,Enterobacter cloacae,Ceftriaxone,7261,4718,2584,2134,16
2017,醫學中心,Enterobacter cloacae,Ertapenem,7261,5861,4788,1073,16
2017,醫學中心,Enterobacter cloacae,Gentamicin,7261,5753,4804,949,14
2017,醫學中心,Enterobacter cloacae,Imipenem,7261,5478,4915,563,16
2017,醫學中心,Enterobacter cloacae,Levofloxacin,7261,4537,3520,1017,14
2017,醫學中心,Enterobacter cloacae,Meropenem,7261,2178,2070,108,16
2017,醫學中心,Escherichia coli,Ampicillin/Sulbactam,65426,45736,20953,24783,14
2017,醫學中心,Escherichia coli,Ampicillin,65426,25749,6247,19502,14
2017,醫學中心,Escherichia coli,Amikacin,65426,61289,60777,512,16
2017,醫學中心,Escherichia coli,Cefuroxime sodium,65426,12919,7785,5134,14
2017,醫學中心,Escherichia coli,Cefotaxime,65426,27142,18636,8506,15
2017,醫學中心,Escherichia coli,Ciprofloxacin,65426,61265,38214,23051,16
2017,醫學中心,Escherichia coli,Ceftazidime,65426,37315,26415,10900,16
2017,醫學中心,Escherichia coli,Cefazolin,65426,47106,24867,22239,14
2017,醫學中心,Escherichia coli,Ceftriaxone,65426,42885,28934,13951,16
2017,醫學中心,Escherichia coli,Ertapenem,65426,51206,50222,984,16
2017,醫學中心,Escherichia coli,Gentamicin,65426,56523,43013,13510,16
2017,醫學中心,Escherichia coli,Imipenem,65426,47062,46598,464,16
2017,醫學中心,Escherichia coli,Levofloxacin,65426,52027,32566,19461,16
2017,醫學中心,Escherichia coli,Meropenem,65426,17547,17410,137,16
2017,醫學中心,Klebsiella pneumoniae,Ampicillin/Sulbactam,45795,23280,13259,10021,14
2017,醫學中心,Klebsiella pneumoniae,Ampicillin,45795,12750,1,12749,14
2017,醫學中心,Klebsiella pneumoniae,Amikacin,45795,31583,29623,1960,16
2017,醫學中心,Klebsiella pneumoniae,Cefuroxime sodium,45795,6852,3886,2966,14
2017,醫學中心,Klebsiella pneumoniae,Cefotaxime,45795,13721,9310,4411,15
2017,醫學中心,Klebsiella pneumoniae,Ciprofloxacin,45795,31559,22611,8948,16
2017,醫學中心,Klebsiella pneumoniae,Ceftazidime,45795,22606,14240,8366,16
2017,醫學中心,Klebsiella pneumoniae,Cefazolin,45795,24215,13149,11066,14
2017,醫學中心,Klebsiella pneumoniae,Ceftriaxone,45795,15611,11222,4389,14
2017,醫學中心,Klebsiella pneumoniae,Ertapenem,45795,35500,31010,4490,21
2017,醫學中心,Klebsiella pneumoniae,Gentamicin,45795,30833,21977,8856,16
2017,醫學中心,Klebsiella pneumoniae,Imipenem,45795,33254,29292,3962,22
2017,醫學中心,Klebsiella pneumoniae,Levofloxacin,45795,20861,15553,5308,14
2017,醫學中心,Klebsiella pneumoniae,Meropenem,45795,10671,9865,806,21
2017,醫學中心,Proteus mirabilis,Ampicillin/Sulbactam,8893,6966,4916,2050,16
2017,醫學中心,Proteus mirabilis,Ampicillin,8893,3818,1748,2070,15
2017,醫學中心,Proteus mirabilis,Amikacin,8893,6901,6652,249,14
2017,醫學中心,Proteus mirabilis,Cefuroxime sodium,8893,1553,1369,184,14
2017,醫學中心,Proteus mirabilis,Cefotaxime,8893,3735,3301,434,14
2017,醫學中心,Proteus mirabilis,Ciprofloxacin,8893,6874,4918,1956,14
2017,醫學中心,Proteus mirabilis,Cefazolin,8893,8127,4188,3939,16
2017,醫學中心,Proteus mirabilis,Ceftriaxone,8893,4365,3910,455,14
2017,醫學中心,Proteus mirabilis,Gentamicin,8893,7963,5379,2584,16
2017,醫學中心,Proteus mirabilis,Levofloxacin,8893,5387,4095,1292,14
2017,醫學中心,Proteus mirabilis,Meropenem,8893,3055,2959,96,14
2017,醫學中心,Pseudomonas aeruginosa,Amikacin,32778,22570,21885,685,14
2017,醫學中心,Pseudomonas aeruginosa,Cefepime,32778,21714,18963,2751,14
2017,醫學中心,Pseudomonas aeruginosa,Ciprofloxacin,32778,28809,23491,5318,16
2017,醫學中心,Pseudomonas aeruginosa,Ceftazidime,32778,26938,22935,4003,16
2017,醫學中心,Pseudomonas aeruginosa,Gentamicin,32778,23578,21257,2321,16
2017,醫學中心,Pseudomonas aeruginosa,Imipenem,32778,27686,23017,4669,17
2017,醫學中心,Pseudomonas aeruginosa,Levofloxacin,32778,23218,17872,5346,16
2017,醫學中心,Pseudomonas aeruginosa,Meropenem,32778,24039,20758,3281,17
2017,醫學中心,Pseudomonas aeruginosa,Piperacillin/Tazobactam,32778,27670,22883,4787,16
2017,醫學中心,Pseudomonas aeruginosa,Piperacillin,32778,2523,2071,452,16
2017,醫學中心,Enterococcus faecalis,Ampicillin,22367,11899,11823,76,16
2017,醫學中心,Enterococcus faecalis,Gentamicin-High,22367,14001,7759,6242,16
2017,醫學中心,Enterococcus faecalis,Vancomycin,22367,22291,22229,62,22
2017,醫學中心,Enterococcus faecium,Ampicillin,14912,7805,721,7084,16
2017,醫學中心,Enterococcus faecium,Gentamicin-High,14912,9664,4762,4902,16
2017,醫學中心,Enterococcus faecium,Vancomycin,14912,14846,6713,8133,22
2017,醫學中心,Staphylococcus aureus,Ciprofloxacin,44332,14742,10635,4107,15
2017,醫學中心,Staphylococcus aureus,Oxacillin,44332,44269,22893,21376,22
2017,醫學中心,Staphylococcus aureus,Trimethoprim/Sulfamethoxazole,44332,30634,25948,4686,16
2017,醫學中心,Staphylococcus aureus,Vancomycin,44332,34046,34040,6,18
2017,醫學中心,Enterococcus spp.,Ampicillin,2983,2473,2027,446,16
2017,醫學中心,Enterococcus spp.,Gentamicin-High,2983,2596,1898,698,16
2017,醫學中心,Enterococcus spp.,Vancomycin,2983,2975,2625,350,21
2017,區域醫院,Acinetobacter baumannii,Ampicillin/Sulbactam,24580,20366,9092,11274,75
2017,區域醫院,Acinetobacter baumannii,Amikacin,24580,13690,6502,7188,75
2017,區域醫院,Acinetobacter baumannii,Cefepime,24580,19048,6636,12412,75
2017,區域醫院,Acinetobacter baumannii,Ciprofloxacin,24580,14507,4578,9929,75
2017,區域醫院,Acinetobacter baumannii,Ceftazidime,24580,20433,6249,14184,75
2017,區域醫院,Acinetobacter baumannii,Colistin,24580,7295,7007,288,75
2017,區域醫院,Acinetobacter baumannii,Gentamicin,24580,19579,6841,12738,75
2017,區域醫院,Acinetobacter baumannii,Imipenem,24580,21053,8149,12904,82
2017,區域醫院,Acinetobacter baumannii,Levofloxacin,24580,13770,4545,9225,75
2017,區域醫院,Acinetobacter baumannii,Meropenem,24580,11521,4833,6688,81
2017,區域醫院,Acinetobacter baumannii,Piperacillin/Tazobactam,24580,18806,5663,13143,75
2017,區域醫院,Acinetobacter baumannii,Piperacillin,24580,4504,630,3874,74
2017,區域醫院,Acinetobacter baumannii,Tigecycline,24580,9108,7402,1706,74
2017,區域醫院,Enterobacter cloacae,Amikacin,9998,8364,8157,207,73
2017,區域醫院,Enterobacter cloacae,Cefotaxime,9998,4495,2842,1653,73
2017,區域醫院,Enterobacter cloacae,Cefepime,9998,7745,6865,880,73
2017,區域醫院,Enterobacter cloacae,Ciprofloxacin,9998,6139,4948,1191,73
2017,區域醫院,Enterobacter cloacae,Ceftazidime,9998,7619,5227,2392,73
2017,區域醫院,Enterobacter cloacae,Ceftriaxone,9998,5698,3763,1935,73
2017,區域醫院,Enterobacter cloacae,Ertapenem,9998,7344,6609,735,74
2017,區域醫院,Enterobacter cloacae,Gentamicin,9998,8671,7685,986,73
2017,區域醫院,Enterobacter cloacae,Imipenem,9998,6513,5963,550,73
2017,區域醫院,Enterobacter cloacae,Levofloxacin,9998,6492,5458,1034,73
2017,區域醫院,Enterobacter cloacae,Meropenem,9998,4430,4349,81,74
2017,區域醫院,Escherichia coli,Ampicillin/Sulbactam,151118,114965,51189,63776,73
2017,區域醫院,Escherichia coli,Ampicillin,151118,61871,13770,48101,73
2017,區域醫院,Escherichia coli,Amikacin,151118,135116,133534,1582,73
2017,區域醫院,Escherichia coli,Cefuroxime sodium,151118,37460,24323,13137,73
2017,區域醫院,Escherichia coli,Cefotaxime,151118,61144,42297,18847,73
2017,區域醫院,Escherichia coli,Ciprofloxacin,151118,106041,65047,40994,73
2017,區域醫院,Escherichia coli,Ceftazidime,151118,106148,79478,26670,73
2017,區域醫院,Escherichia coli,Cefazolin,151118,111585,59532,52053,73
2017,區域醫院,Escherichia coli,Ceftriaxone,151118,94090,63969,30121,73
2017,區域醫院,Escherichia coli,Ertapenem,151118,117443,113964,3479,76
2017,區域醫院,Escherichia coli,Gentamicin,151118,138393,103062,35331,73
2017,區域醫院,Escherichia coli,Imipenem,151118,91327,89785,1542,76
2017,區域醫院,Escherichia coli,Levofloxacin,151118,108266,67722,40544,73
2017,區域醫院,Escherichia coli,Meropenem,151118,58365,55914,2451,75
2017,區域醫院,Klebsiella pneumoniae,Ampicillin/Sulbactam,67278,45975,25695,20280,75
2017,區域醫院,Klebsiella pneumoniae,Ampicillin,67278,21554,420,21134,74
2017,區域醫院,Klebsiella pneumoniae,Amikacin,67278,55656,51951,3705,75
2017,區域醫院,Klebsiella pneumoniae,Cefuroxime sodium,67278,12677,7485,5192,74
2017,區域醫院,Klebsiella pneumoniae,Cefotaxime,67278,25557,16376,9181,75
2017,區域醫院,Klebsiella pneumoniae,Ciprofloxacin,67278,42773,29158,13615,75
2017,區域醫院,Klebsiella pneumoniae,Ceftazidime,67278,45918,30514,15404,75
2017,區域醫院,Klebsiella pneumoniae,Cefazolin,67278,46167,24963,21204,75
2017,區域醫院,Klebsiella pneumoniae,Ceftriaxone,67278,32058,22890,9168,74
2017,區域醫院,Klebsiella pneumoniae,Ertapenem,67278,49464,43220,6244,80
2017,區域醫院,Klebsiella pneumoniae,Gentamicin,67278,57434,41267,16167,75
2017,區域醫院,Klebsiella pneumoniae,Imipenem,67278,43521,38257,5264,82
2017,區域醫院,Klebsiella pneumoniae,Levofloxacin,67278,37956,27862,10094,75
2017,區域醫院,Klebsiella pneumoniae,Meropenem,67278,26039,23817,2222,81
2017,區域醫院,Proteus mirabilis,Ampicillin/Sulbactam,24081,20535,12631,7904,73
2017,區域醫院,Proteus mirabilis,Ampicillin,24081,9260,3031,6229,73
2017,區域醫院,Proteus mirabilis,Amikacin,24081,20407,18650,1757,73
2017,區域醫院,Proteus mirabilis,Cefuroxime sodium,24081,5506,4158,1348,73
2017,區域醫院,Proteus mirabilis,Cefotaxime,24081,11381,8900,2481,73
2017,區域醫院,Proteus mirabilis,Ciprofloxacin,24081,16483,10220,6263,73
2017,區域醫院,Proteus mirabilis,Cefazolin,24081,20899,9146,11753,73
2017,區域醫院,Proteus mirabilis,Ceftriaxone,24081,11275,9345,1930,73
2017,區域醫院,Proteus mirabilis,Gentamicin,24081,22813,13419,9394,73
2017,區域醫院,Proteus mirabilis,Levofloxacin,24081,15695,10844,4851,73
2017,區域醫院,Proteus mirabilis,Meropenem,24081,11430,11160,270,74
2017,區域醫院,Pseudomonas aeruginosa,Amikacin,52067,40695,38978,1717,73
2017,區域醫院,Pseudomonas aeruginosa,Cefepime,52067,39973,34831,5142,73
2017,區域醫院,Pseudomonas aeruginosa,Ciprofloxacin,52067,39892,30403,9489,73
2017,區域醫院,Pseudomonas aeruginosa,Ceftazidime,52067,48695,41736,6959,73
2017,區域醫院,Pseudomonas aeruginosa,Gentamicin,52067,47655,39829,7826,73
2017,區域醫院,Pseudomonas aeruginosa,Imipenem,52067,41579,35068,6511,76
2017,區域醫院,Pseudomonas aeruginosa,Levofloxacin,52067,41080,30036,11044,73
2017,區域醫院,Pseudomonas aeruginosa,Meropenem,52067,32222,27907,4315,76
2017,區域醫院,Pseudomonas aeruginosa,Piperacillin/Tazobactam,52067,46170,38510,7660,73
2017,區域醫院,Pseudomonas aeruginosa,Piperacillin,52067,11810,8702,3108,73
2017,區域醫院,Enterococcus faecalis,Ampicillin,22119,15366,14937,429,74
2017,區域醫院,Enterococcus faecalis,Gentamicin-High,22119,17195,8868,8327,74
2017,區域醫院,Enterococcus faecalis,Vancomycin,22119,22027,21790,237,81
2017,區域醫院,Enterococcus faecium,Ampicillin,11971,8805,882,7923,74
2017,區域醫院,Enterococcus faecium,Gentamicin-High,11971,8222,3684,4538,74
2017,區域醫院,Enterococcus faecium,Vancomycin,11971,11894,5586,6308,81
2017,區域醫院,Staphylococcus aureus,Ciprofloxacin,57758,20956,12659,8297,75
2017,區域醫院,Staphylococcus aureus,Oxacillin,57758,55665,25216,30449,82
2017,區域醫院,Staphylococcus aureus,Trimethoprim/Sulfamethoxazole,57758,51655,43895,7760,75
2017,區域醫院,Staphylococcus aureus,Vancomycin,57758,49378,49148,230,76
2017,區域醫院,Enterococcus spp.,Ampicillin,10461,8743,6521,2222,71
2017,區域醫院,Enterococcus spp.,Gentamicin-High,10461,8534,4745,3789,71
2017,區域醫院,Enterococcus spp.,Vancomycin,10461,10453,8842,1611,75
2017,地區醫院,Acinetobacter baumannii,Ampicillin/Sulbactam,14529,9893,3481,6412,207
2017,地區醫院,Acinetobacter baumannii,Amikacin,14529,9033,2714,6319,206
2017,地區醫院,Acinetobacter baumannii,Cefepime,14529,9810,1508,8302,206
2017,地區醫院,Acinetobacter baumannii,Ciprofloxacin,14529,9178,1257,7921,207
2017,地區醫院,Acinetobacter baumannii,Ceftazidime,14529,11441,2111,9330,206
2017,地區醫院,Acinetobacter baumannii,Colistin,14529,4622,4473,149,204
2017,地區醫院,Acinetobacter baumannii,Gentamicin,14529,11019,2266,8753,207
2017,地區醫院,Acinetobacter baumannii,Imipenem,14529,11874,2782,9092,216
2017,地區醫院,Acinetobacter baumannii,Levofloxacin,14529,8463,1158,7305,205
2017,地區醫院,Acinetobacter baumannii,Meropenem,14529,7381,1629,5752,213
2017,地區醫院,Acinetobacter baumannii,Piperacillin/Tazobactam,14529,10477,1530,8947,207
2017,地區醫院,Acinetobacter baumannii,Piperacillin,14529,2072,217,1855,205
2017,地區醫院,Acinetobacter baumannii,Tigecycline,14529,4713,3483,1230,205
2017,地區醫院,Enterobacter cloacae,Amikacin,3556,2918,2741,177,197
2017,地區醫院,Enterobacter cloacae,Cefotaxime,3556,1088,710,378,197
2017,地區醫院,Enterobacter cloacae,Cefepime,3556,2134,1748,386,197
2017,地區醫院,Enterobacter cloacae,Ciprofloxacin,3556,2201,1543,658,198
2017,地區醫院,Enterobacter cloacae,Ceftazidime,3556,2800,2028,772,199
2017,地區醫院,Enterobacter cloacae,Ceftriaxone,3556,2492,1658,834,198
2017,地區醫院,Enterobacter cloacae,Ertapenem,3556,1942,1760,182,197
2017,地區醫院,Enterobacter cloacae,Gentamicin,3556,3187,2437,750,198
2017,地區醫院,Enterobacter cloacae,Imipenem,3556,2553,2394,159,199
2017,地區醫院,Enterobacter cloacae,Levofloxacin,3556,2289,1596,693,197
2017,地區醫院,Enterobacter cloacae,Meropenem,3556,1467,1364,103,197
2017,地區醫院,Escherichia coli,Ampicillin/Sulbactam,63301,37782,16124,21658,204
2017,地區醫院,Escherichia coli,Ampicillin,63301,30150,6262,23888,205
2017,地區醫院,Escherichia coli,Amikacin,63301,52183,50098,2085,207
2017,地區醫院,Escherichia coli,Cefuroxime sodium,63301,17761,10264,7497,202
2017,地區醫院,Escherichia coli,Cefotaxime,63301,17977,11153,6824,204
2017,地區醫院,Escherichia coli,Ciprofloxacin,63301,46374,23880,22494,207
2017,地區醫院,Escherichia coli,Ceftazidime,63301,47700,31628,16072,207
2017,地區醫院,Escherichia coli,Cefazolin,63301,50571,22103,28468,205
2017,地區醫院,Escherichia coli,Ceftriaxone,63301,42745,26326,16419,206
2017,地區醫院,Escherichia coli,Ertapenem,63301,36435,34154,2281,204
2017,地區醫院,Escherichia coli,Gentamicin,63301,59444,41551,17893,207
2017,地區醫院,Escherichia coli,Imipenem,63301,40816,38986,1830,210
2017,地區醫院,Escherichia coli,Levofloxacin,63301,38466,20282,18184,206
2017,地區醫院,Escherichia coli,Meropenem,63301,31832,29443,2389,206
2017,地區醫院,Klebsiella pneumoniae,Ampicillin/Sulbactam,31000,15997,7226,8771,206
2017,地區醫院,Klebsiella pneumoniae,Ampicillin,31000,14733,477,14256,205
2017,地區醫院,Klebsiella pneumoniae,Amikacin,31000,22907,20234,2673,208
2017,地區醫院,Klebsiella pneumoniae,Cefuroxime sodium,31000,7819,4109,3710,204
2017,地區醫院,Klebsiella pneumoniae,Cefotaxime,31000,8248,5098,3150,205
2017,地區醫院,Klebsiella pneumoniae,Ciprofloxacin,31000,20518,12167,8351,208
2017,地區醫院,Klebsiella pneumoniae,Ceftazidime,31000,22124,13363,8761,207
2017,地區醫院,Klebsiella pneumoniae,Cefazolin,31000,22151,9992,12159,206
2017,地區醫院,Klebsiella pneumoniae,Ceftriaxone,31000,17780,11084,6696,206
2017,地區醫院,Klebsiella pneumoniae,Ertapenem,31000,18572,15318,3254,213
2017,地區醫院,Klebsiella pneumoniae,Gentamicin,31000,26036,17688,8348,208
2017,地區醫院,Klebsiella pneumoniae,Imipenem,31000,22520,19736,2784,217
2017,地區醫院,Klebsiella pneumoniae,Levofloxacin,31000,15435,9473,5962,206
2017,地區醫院,Klebsiella pneumoniae,Meropenem,31000,12939,11077,1862,212
2017,地區醫院,Proteus mirabilis,Ampicillin/Sulbactam,15567,10159,4348,5811,203
2017,地區醫院,Proteus mirabilis,Ampicillin,15567,8329,1582,6747,202
2017,地區醫院,Proteus mirabilis,Amikacin,15567,12814,9478,3336,203
2017,地區醫院,Proteus mirabilis,Cefuroxime sodium,15567,3668,2388,1280,199
2017,地區醫院,Proteus mirabilis,Cefotaxime,15567,4467,2920,1547,200
2017,地區醫院,Proteus mirabilis,Ciprofloxacin,15567,11273,5069,6204,203
2017,地區醫院,Proteus mirabilis,Cefazolin,15567,11995,3247,8748,202
2017,地區醫院,Proteus mirabilis,Ceftriaxone,15567,10241,7032,3209,202
2017,地區醫院,Proteus mirabilis,Gentamicin,15567,14724,5453,9271,205
2017,地區醫院,Proteus mirabilis,Levofloxacin,15567,9417,4595,4822,201
2017,地區醫院,Proteus mirabilis,Meropenem,15567,7725,6880,845,199
2017,地區醫院,Pseudomonas aeruginosa,Amikacin,30028,24831,22603,2228,203
2017,地區醫院,Pseudomonas aeruginosa,Cefepime,30028,21163,16367,4796,201
2017,地區醫院,Pseudomonas aeruginosa,Ciprofloxacin,30028,22658,11993,10665,203
2017,地區醫院,Pseudomonas aeruginosa,Ceftazidime,30028,27046,21511,5535,203
2017,地區醫院,Pseudomonas aeruginosa,Gentamicin,30028,26727,17489,9238,204
2017,地區醫院,Pseudomonas aeruginosa,Imipenem,30028,22236,16986,5250,205
2017,地區醫院,Pseudomonas aeruginosa,Levofloxacin,30028,20884,10206,10678,201
2017,地區醫院,Pseudomonas aeruginosa,Meropenem,30028,18050,13650,4400,202
2017,地區醫院,Pseudomonas aeruginosa,Piperacillin/Tazobactam,30028,25065,18486,6579,202
2017,地區醫院,Pseudomonas aeruginosa,Piperacillin,30028,7234,4758,2476,202
2017,地區醫院,Enterococcus faecalis,Ampicillin,5511,4069,3929,140,189
2017,地區醫院,Enterococcus faecalis,Gentamicin-High,5511,3931,1709,2222,189
2017,地區醫院,Enterococcus faecalis,Vancomycin,5511,5475,5327,148,194
2017,地區醫院,Enterococcus faecium,Ampicillin,2609,1969,135,1834,186
2017,地區醫院,Enterococcus faecium,Gentamicin-High,2609,1888,784,1104,185
2017,地區醫院,Enterococcus faecium,Vancomycin,2609,2564,1320,1244,190
2017,地區醫院,Staphylococcus aureus,Ciprofloxacin,25610,10066,5696,4370,211
2017,地區醫院,Staphylococcus aureus,Oxacillin,25610,24757,9853,14904,220
2017,地區醫院,Staphylococcus aureus,Trimethoprim/Sulfamethoxazole,25610,19328,16365,2963,213
2017,地區醫院,Staphylococcus aureus,Vancomycin,25610,23006,22833,173,217
2017,地區醫院,Enterococcus spp.,Ampicillin,7311,3665,2552,1113,200
2017,地區醫院,Enterococcus spp.,Gentamicin-High,7311,4212,2094,2118,199
2017,地區醫院,Enterococcus spp.,Vancomycin,7311,7136,6020,1116,208
2016,醫學中心,Acinetobacter baumannii,Ampicillin/Sulbactam,23900,13170,7025,6145,16
2016,醫學中心,Acinetobacter baumannii,Amikacin,23900,12121,5227,6894,16
2016,醫學中心,Acinetobacter baumannii,Cefepime,23900,16678,6805,9873,16
2016,醫學中心,Acinetobacter baumannii,Ciprofloxacin,23900,17596,6436,11160,16
2016,醫學中心,Acinetobacter baumannii,Ceftazidime,23900,17699,7092,10607,16
2016,醫學中心,Acinetobacter baumannii,Colistin,23900,10206,9992,214,14
2016,醫學中心,Acinetobacter baumannii,Gentamicin,23900,13891,5391,8500,16
2016,醫學中心,Acinetobacter baumannii,Imipenem,23900,23817,9740,14077,22
2016,醫學中心,Acinetobacter baumannii,Levofloxacin,23900,11200,4474,6726,16
2016,醫學中心,Acinetobacter baumannii,Meropenem,23900,15202,6841,8361,21
2016,醫學中心,Acinetobacter baumannii,Piperacillin/Tazobactam,23900,16715,6125,10590,16
2016,醫學中心,Acinetobacter baumannii,Piperacillin,23900,1088,366,722,14
2016,醫學中心,Acinetobacter baumannii,Tigecycline,23900,8792,5748,3044,14
2016,醫學中心,Enterobacter cloacae,Amikacin,8106,5944,5877,67,14
2016,醫學中心,Enterobacter cloacae,Cefotaxime,8106,2882,1743,1139,15
2016,醫學中心,Enterobacter cloacae,Cefepime,8106,5552,4727,825,14
2016,醫學中心,Enterobacter cloacae,Ciprofloxacin,8106,5685,4641,1044,14
2016,醫學中心,Enterobacter cloacae,Ceftazidime,8106,5850,3404,2446,16
2016,醫學中心,Enterobacter cloacae,Ceftriaxone,8106,5384,3077,2307,16
2016,醫學中心,Enterobacter cloacae,Ertapenem,8106,7085,5970,1115,16
2016,醫學中心,Enterobacter cloacae,Gentamicin,8106,6188,5246,942,14
2016,醫學中心,Enterobacter cloacae,Imipenem,8106,5827,5257,570,16
2016,醫學中心,Enterobacter cloacae,Levofloxacin,8106,4640,3849,791,14
2016,醫學中心,Enterobacter cloacae,Meropenem,8106,2277,2182,95,16
2016,醫學中心,Escherichia coli,Ampicillin/Sulbactam,79260,47589,22173,25416,14
2016,醫學中心,Escherichia coli,Ampicillin,79260,30115,8762,21353,14
2016,醫學中心,Escherichia coli,Amikacin,79260,76930,76349,581,16
2016,醫學中心,Escherichia coli,Cefuroxime sodium,79260,14985,9260,5725,14
2016,醫學中心,Escherichia coli,Cefotaxime,79260,27916,19819,8097,15
2016,醫學中心,Escherichia coli,Ciprofloxacin,79260,74285,46613,27672,16
2016,醫學中心,Escherichia coli,Ceftazidime,79260,42057,30395,11662,16
2016,醫學中心,Escherichia coli,Cefazolin,79260,48708,25986,22722,14
2016,醫學中心,Escherichia coli,Ceftriaxone,79260,54805,37448,17357,16
2016,醫學中心,Escherichia coli,Ertapenem,79260,69217,68273,944,16
2016,醫學中心,Escherichia coli,Gentamicin,79260,70494,52856,17638,16
2016,醫學中心,Escherichia coli,Imipenem,79260,48948,48502,446,16
2016,醫學中心,Escherichia coli,Levofloxacin,79260,66512,41935,24577,16
2016,醫學中心,Escherichia coli,Meropenem,79260,17171,17103,68,16
2016,醫學中心,Klebsiella pneumoniae,Ampicillin/Sulbactam,49651,24082,13911,10171,15
2016,醫學中心,Klebsiella pneumoniae,Ampicillin,49651,14168,441,13727,15
2016,醫學中心,Klebsiella pneumoniae,Amikacin,49651,34340,32403,1937,16
2016,醫學中心,Klebsiella pneumoniae,Cefuroxime sodium,49651,8245,4299,3946,14
2016,醫學中心,Klebsiella pneumoniae,Cefotaxime,49651,14549,9896,4653,15
2016,醫學中心,Klebsiella pneumoniae,Ciprofloxacin,49651,33492,23870,9622,16
2016,醫學中心,Klebsiella pneumoniae,Ceftazidime,49651,24410,15878,8532,16
2016,醫學中心,Klebsiella pneumoniae,Cefazolin,49651,25028,13401,11627,15
2016,醫學中心,Klebsiella pneumoniae,Ceftriaxone,49651,14872,10868,4004,15
2016,醫學中心,Klebsiella pneumoniae,Ertapenem,49651,40292,35532,4760,21
2016,醫學中心,Klebsiella pneumoniae,Gentamicin,49651,32943,23577,9366,16
2016,醫學中心,Klebsiella pneumoniae,Imipenem,49651,35468,31982,3486,22
2016,醫學中心,Klebsiella pneumoniae,Levofloxacin,49651,22144,16306,5838,15
2016,醫學中心,Klebsiella pneumoniae,Meropenem,49651,11668,10625,1043,21
2016,醫學中心,Proteus mirabilis,Ampicillin/Sulbactam,10098,7632,5454,2178,16
2016,醫學中心,Proteus mirabilis,Ampicillin,10098,4146,1791,2355,15
2016,醫學中心,Proteus mirabilis,Amikacin,10098,7140,6919,221,14
2016,醫學中心,Proteus mirabilis,Cefuroxime sodium,10098,2010,1766,244,14
2016,醫學中心,Proteus mirabilis,Cefotaxime,10098,3851,3468,383,14
2016,醫學中心,Proteus mirabilis,Ciprofloxacin,10098,7064,5070,1994,14
2016,醫學中心,Proteus mirabilis,Cefazolin,10098,9622,4868,4754,16
2016,醫學中心,Proteus mirabilis,Ceftriaxone,10098,4304,3808,496,14
2016,醫學中心,Proteus mirabilis,Gentamicin,10098,9266,6402,2864,16
2016,醫學中心,Proteus mirabilis,Levofloxacin,10098,5864,4461,1403,14
2016,醫學中心,Proteus mirabilis,Meropenem,10098,2601,2501,100,14
2016,醫學中心,Pseudomonas aeruginosa,Amikacin,36365,25113,24437,676,14
2016,醫學中心,Pseudomonas aeruginosa,Cefepime,36365,23938,20580,3358,14
2016,醫學中心,Pseudomonas aeruginosa,Ciprofloxacin,36365,32706,26354,6352,16
2016,醫學中心,Pseudomonas aeruginosa,Ceftazidime,36365,32732,27715,5017,16
2016,醫學中心,Pseudomonas aeruginosa,Gentamicin,36365,30002,26739,3263,16
2016,醫學中心,Pseudomonas aeruginosa,Imipenem,36365,32532,26949,5583,16
2016,醫學中心,Pseudomonas aeruginosa,Levofloxacin,36365,28944,22050,6894,16
2016,醫學中心,Pseudomonas aeruginosa,Meropenem,36365,23992,20798,3194,17
2016,醫學中心,Pseudomonas aeruginosa,Piperacillin/Tazobactam,36365,31347,25883,5464,16
2016,醫學中心,Pseudomonas aeruginosa,Piperacillin,36365,10263,8232,2031,16
2016,醫學中心,Enterococcus faecalis,Ampicillin,22177,11376,10849,527,16
2016,醫學中心,Enterococcus faecalis,Gentamicin-High,22177,10830,6023,4807,15
2016,醫學中心,Enterococcus faecalis,Vancomycin,22177,22163,22090,73,22
2016,醫學中心,Enterococcus faecium,Ampicillin,14465,7383,793,6590,16
2016,醫學中心,Enterococcus faecium,Gentamicin-High,14465,7819,3220,4599,15
2016,醫學中心,Enterococcus faecium,Vancomycin,14465,14447,6233,8214,22
2016,醫學中心,Staphylococcus aureus,Ciprofloxacin,49085,15804,11886,3918,15
2016,醫學中心,Staphylococcus aureus,Oxacillin,49085,49037,24518,24519,22
2016,醫學中心,Staphylococcus aureus,Trimethoprim/Sulfamethoxazole,49085,31709,26425,5284,16
2016,醫學中心,Staphylococcus aureus,Vancomycin,49085,38545,38531,14,17
2016,醫學中心,Enterococcus spp.,Ampicillin,5035,3971,3215,756,16
2016,醫學中心,Enterococcus spp.,Gentamicin-High,5035,4137,2909,1228,15
2016,醫學中心,Enterococcus spp.,Vancomycin,5035,5021,4588,433,21
2016,區域醫院,Acinetobacter baumannii,Ampicillin/Sulbactam,28671,24161,10766,13395,74
2016,區域醫院,Acinetobacter baumannii,Amikacin,28671,17571,8394,9177,74
2016,區域醫院,Acinetobacter baumannii,Cefepime,28671,23137,8212,14925,74
2016,區域醫院,Acinetobacter baumannii,Ciprofloxacin,28671,17998,6168,11830,74
2016,區域醫院,Acinetobacter baumannii,Ceftazidime,28671,24333,7836,16497,74
2016,區域醫院,Acinetobacter baumannii,Colistin,28671,11138,10929,209,74
2016,區域醫院,Acinetobacter baumannii,Gentamicin,28671,24201,8506,15695,74
2016,區域醫院,Acinetobacter baumannii,Imipenem,28671,23700,9784,13916,81
2016,區域醫院,Acinetobacter baumannii,Levofloxacin,28671,18192,6395,11797,74
2016,區域醫院,Acinetobacter baumannii,Meropenem,28671,17164,7893,9271,79
2016,區域醫院,Acinetobacter baumannii,Piperacillin/Tazobactam,28671,23384,7529,15855,74
2016,區域醫院,Acinetobacter baumannii,Piperacillin,28671,6333,1645,4688,74
2016,區域醫院,Acinetobacter baumannii,Tigecycline,28671,14365,11039,3326,74
2016,區域醫院,Enterobacter cloacae,Amikacin,11039,9523,9318,205,72
2016,區域醫院,Enterobacter cloacae,Cefotaxime,11039,4823,3242,1581,72
2016,區域醫院,Enterobacter cloacae,Cefepime,11039,8759,7771,988,72
2016,區域醫院,Enterobacter cloacae,Ciprofloxacin,11039,7116,5768,1348,72
2016,區域醫院,Enterobacter cloacae,Ceftazidime,11039,8335,5920,2415,72
2016,區域醫院,Enterobacter cloacae,Ceftriaxone,11039,6836,4582,2254,72
2016,區域醫院,Enterobacter cloacae,Ertapenem,11039,8160,7383,777,73
2016,區域醫院,Enterobacter cloacae,Gentamicin,11039,9787,8429,1358,72
2016,區域醫院,Enterobacter cloacae,Imipenem,11039,6976,6314,662,73
2016,區域醫院,Enterobacter cloacae,Levofloxacin,11039,7865,6710,1155,72
2016,區域醫院,Enterobacter cloacae,Meropenem,11039,5704,5566,138,73
2016,區域醫院,Escherichia coli,Ampicillin/Sulbactam,156610,123534,56275,67259,72
2016,區域醫院,Escherichia coli,Ampicillin,156610,72823,20264,52559,72
2016,區域醫院,Escherichia coli,Amikacin,156610,143327,141476,1851,72
2016,區域醫院,Escherichia coli,Cefuroxime sodium,156610,36664,24371,12293,72
2016,區域醫院,Escherichia coli,Cefotaxime,156610,68088,45884,22204,73
2016,區域醫院,Escherichia coli,Ciprofloxacin,156610,109877,66234,43643,72
2016,區域醫院,Escherichia coli,Ceftazidime,156610,107393,80469,26924,72
2016,區域醫院,Escherichia coli,Cefazolin,156610,119293,60021,59272,72
2016,區域醫院,Escherichia coli,Ceftriaxone,156610,95395,65527,29868,72
2016,區域醫院,Escherichia coli,Ertapenem,156610,118290,116620,1670,75
2016,區域醫院,Escherichia coli,Gentamicin,156610,148022,107710,40312,72
2016,區域醫院,Escherichia coli,Imipenem,156610,97513,96563,950,75
2016,區域醫院,Escherichia coli,Levofloxacin,156610,119150,74309,44841,72
2016,區域醫院,Escherichia coli,Meropenem,156610,69906,69122,784,74
2016,區域醫院,Klebsiella pneumoniae,Ampicillin/Sulbactam,70017,50275,27477,22798,74
2016,區域醫院,Klebsiella pneumoniae,Ampicillin,70017,28422,641,27781,74
2016,區域醫院,Klebsiella pneumoniae,Amikacin,70017,60095,56764,3331,74
2016,區域醫院,Klebsiella pneumoniae,Cefuroxime sodium,70017,12329,7166,5163,74
2016,區域醫院,Klebsiella pneumoniae,Cefotaxime,70017,28265,17560,10705,74
2016,區域醫院,Klebsiella pneumoniae,Ciprofloxacin,70017,48202,32138,16064,74
2016,區域醫院,Klebsiella pneumoniae,Ceftazidime,70017,48164,31908,16256,74
2016,區域醫院,Klebsiella pneumoniae,Cefazolin,70017,50533,25479,25054,74
2016,區域醫院,Klebsiella pneumoniae,Ceftriaxone,70017,33991,24373,9618,74
2016,區域醫院,Klebsiella pneumoniae,Ertapenem,70017,48265,41851,6414,79
2016,區域醫院,Klebsiella pneumoniae,Gentamicin,70017,62173,45108,17065,74
2016,區域醫院,Klebsiella pneumoniae,Imipenem,70017,46318,41197,5121,81
2016,區域醫院,Klebsiella pneumoniae,Levofloxacin,70017,43214,30708,12506,74
2016,區域醫院,Klebsiella pneumoniae,Meropenem,70017,32044,29774,2270,79
2016,區域醫院,Proteus mirabilis,Ampicillin/Sulbactam,24208,21034,12794,8240,72
2016,區域醫院,Proteus mirabilis,Ampicillin,24208,13420,4161,9259,72
2016,區域醫院,Proteus mirabilis,Amikacin,24208,21088,19488,1600,72
2016,區域醫院,Proteus mirabilis,Cefuroxime sodium,24208,5816,4366,1450,72
2016,區域醫院,Proteus mirabilis,Cefotaxime,24208,12133,9319,2814,72
2016,區域醫院,Proteus mirabilis,Ciprofloxacin,24208,16984,10641,6343,72
2016,區域醫院,Proteus mirabilis,Cefazolin,24208,21257,8834,12423,72
2016,區域醫院,Proteus mirabilis,Ceftriaxone,24208,11912,10055,1857,72
2016,區域醫院,Proteus mirabilis,Gentamicin,24208,23314,13582,9732,72
2016,區域醫院,Proteus mirabilis,Levofloxacin,24208,17372,11974,5398,72
2016,區域醫院,Proteus mirabilis,Meropenem,24208,12545,12406,139,73
2016,區域醫院,Pseudomonas aeruginosa,Amikacin,59116,48213,46252,1961,72
2016,區域醫院,Pseudomonas aeruginosa,Cefepime,59116,47890,41327,6563,72
2016,區域醫院,Pseudomonas aeruginosa,Ciprofloxacin,59116,45408,33588,11820,72
2016,區域醫院,Pseudomonas aeruginosa,Ceftazidime,59116,55914,47929,7985,72
2016,區域醫院,Pseudomonas aeruginosa,Gentamicin,59116,55739,45938,9801,72
2016,區域醫院,Pseudomonas aeruginosa,Imipenem,59116,47098,40788,6310,74
2016,區域醫院,Pseudomonas aeruginosa,Levofloxacin,59116,47458,34135,13323,72
2016,區域醫院,Pseudomonas aeruginosa,Meropenem,59116,40942,36198,4744,74
2016,區域醫院,Pseudomonas aeruginosa,Piperacillin/Tazobactam,59116,54292,45854,8438,72
2016,區域醫院,Pseudomonas aeruginosa,Piperacillin,59116,18223,14110,4113,72
2016,區域醫院,Enterococcus faecalis,Ampicillin,23453,16558,15813,745,72
2016,區域醫院,Enterococcus faecalis,Gentamicin-High,23453,17636,9217,8419,72
2016,區域醫院,Enterococcus faecalis,Vancomycin,23453,23298,23058,240,79
2016,區域醫院,Enterococcus faecium,Ampicillin,10939,8133,771,7362,73
2016,區域醫院,Enterococcus faecium,Gentamicin-High,10939,7550,3173,4377,73
2016,區域醫院,Enterococcus faecium,Vancomycin,10939,10725,5363,5362,80
2016,區域醫院,Staphylococcus aureus,Ciprofloxacin,60724,18838,12154,6684,74
2016,區域醫院,Staphylococcus aureus,Oxacillin,60724,59175,27081,32094,81
2016,區域醫院,Staphylococcus aureus,Trimethoprim/Sulfamethoxazole,60724,53447,44483,8964,74
2016,區域醫院,Staphylococcus aureus,Vancomycin,60724,51285,51057,228,75
2016,區域醫院,Enterococcus spp.,Ampicillin,12297,9875,7206,2669,69
2016,區域醫院,Enterococcus spp.,Gentamicin-High,12297,9390,5160,4230,69
2016,區域醫院,Enterococcus spp.,Vancomycin,12297,12249,10477,1772,73
2016,地區醫院,Acinetobacter baumannii,Ampicillin/Sulbactam,15474,9885,3143,6742,186
2016,地區醫院,Acinetobacter baumannii,Amikacin,15474,9403,2635,6768,186
2016,地區醫院,Acinetobacter baumannii,Cefepime,15474,9746,1482,8264,186
2016,地區醫院,Acinetobacter baumannii,Ciprofloxacin,15474,9177,1210,7967,184
2016,地區醫院,Acinetobacter baumannii,Ceftazidime,15474,11995,2016,9979,188
2016,地區醫院,Acinetobacter baumannii,Colistin,15474,4463,4350,113,182
2016,地區醫院,Acinetobacter baumannii,Gentamicin,15474,11333,2198,9135,186
2016,地區醫院,Acinetobacter baumannii,Imipenem,15474,12978,3147,9831,195
2016,地區醫院,Acinetobacter baumannii,Levofloxacin,15474,9204,1212,7992,185
2016,地區醫院,Acinetobacter baumannii,Meropenem,15474,7256,1732,5524,190
2016,地區醫院,Acinetobacter baumannii,Piperacillin/Tazobactam,15474,10893,1719,9174,186
2016,地區醫院,Acinetobacter baumannii,Piperacillin,15474,2665,222,2443,182
2016,地區醫院,Acinetobacter baumannii,Tigecycline,15474,5080,3867,1213,181
2016,地區醫院,Enterobacter cloacae,Amikacin,3045,2573,2384,189,173
2016,地區醫院,Enterobacter cloacae,Cefotaxime,3045,1138,751,387,174
2016,地區醫院,Enterobacter cloacae,Cefepime,3045,1777,1514,263,173
2016,地區醫院,Enterobacter cloacae,Ciprofloxacin,3045,1927,1411,516,173
2016,地區醫院,Enterobacter cloacae,Ceftazidime,3045,2451,1820,631,176
2016,地區醫院,Enterobacter cloacae,Ceftriaxone,3045,2122,1439,683,174
2016,地區醫院,Enterobacter cloacae,Ertapenem,3045,1692,1530,162,175
2016,地區醫院,Enterobacter cloacae,Gentamicin,3045,2801,2201,600,173
2016,地區醫院,Enterobacter cloacae,Imipenem,3045,2288,2151,137,176
2016,地區醫院,Enterobacter cloacae,Levofloxacin,3045,1957,1481,476,172
2016,地區醫院,Enterobacter cloacae,Meropenem,3045,1204,1155,49,175
2016,地區醫院,Escherichia coli,Ampicillin/Sulbactam,60194,32768,14712,18056,183
2016,地區醫院,Escherichia coli,Ampicillin,60194,28193,6051,22142,182
2016,地區醫院,Escherichia coli,Amikacin,60194,49508,47298,2210,186
2016,地區醫院,Escherichia coli,Cefuroxime sodium,60194,13126,7426,5700,183
2016,地區醫院,Escherichia coli,Cefotaxime,60194,20313,13046,7267,184
2016,地區醫院,Escherichia coli,Ciprofloxacin,60194,43713,23317,20396,186
2016,地區醫院,Escherichia coli,Ceftazidime,60194,44605,29806,14799,186
2016,地區醫院,Escherichia coli,Cefazolin,60194,46131,19971,26160,183
2016,地區醫院,Escherichia coli,Ceftriaxone,60194,37616,23325,14291,184
2016,地區醫院,Escherichia coli,Ertapenem,60194,34629,32717,1912,186
2016,地區醫院,Escherichia coli,Gentamicin,60194,56116,38144,17972,186
2016,地區醫院,Escherichia coli,Imipenem,60194,37683,36211,1472,188
2016,地區醫院,Escherichia coli,Levofloxacin,60194,36984,20197,16787,186
2016,地區醫院,Escherichia coli,Meropenem,60194,29226,27992,1234,185
2016,地區醫院,Klebsiella pneumoniae,Ampicillin/Sulbactam,29790,14368,6262,8106,187
2016,地區醫院,Klebsiella pneumoniae,Ampicillin,29790,13193,391,12802,187
2016,地區醫院,Klebsiella pneumoniae,Amikacin,29790,21779,19008,2771,190
2016,地區醫院,Klebsiella pneumoniae,Cefuroxime sodium,29790,6162,3187,2975,187
2016,地區醫院,Klebsiella pneumoniae,Cefotaxime,29790,8268,5040,3228,188
2016,地區醫院,Klebsiella pneumoniae,Ciprofloxacin,29790,18772,11010,7762,190
2016,地區醫院,Klebsiella pneumoniae,Ceftazidime,29790,20697,12397,8300,190
2016,地區醫院,Klebsiella pneumoniae,Cefazolin,29790,20073,9010,11063,187
2016,地區醫院,Klebsiella pneumoniae,Ceftriaxone,29790,15550,9727,5823,187
2016,地區醫院,Klebsiella pneumoniae,Ertapenem,29790,17414,14556,2858,196
2016,地區醫院,Klebsiella pneumoniae,Gentamicin,29790,24085,16076,8009,190
2016,地區醫院,Klebsiella pneumoniae,Imipenem,29790,22089,19535,2554,198
2016,地區醫院,Klebsiella pneumoniae,Levofloxacin,29790,14433,9163,5270,187
2016,地區醫院,Klebsiella pneumoniae,Meropenem,29790,12304,10918,1386,193
2016,地區醫院,Proteus mirabilis,Ampicillin/Sulbactam,15551,9790,4044,5746,184
2016,地區醫院,Proteus mirabilis,Ampicillin,15551,8271,1530,6741,183
2016,地區醫院,Proteus mirabilis,Amikacin,15551,12886,9572,3314,182
2016,地區醫院,Proteus mirabilis,Cefuroxime sodium,15551,3277,2029,1248,182
2016,地區醫院,Proteus mirabilis,Cefotaxime,15551,5125,3326,1799,182
2016,地區醫院,Proteus mirabilis,Ciprofloxacin,15551,11018,5102,5916,182
2016,地區醫院,Proteus mirabilis,Cefazolin,15551,11947,3146,8801,183
2016,地區醫院,Proteus mirabilis,Ceftriaxone,15551,9729,6825,2904,181
2016,地區醫院,Proteus mirabilis,Gentamicin,15551,14667,5111,9556,185
2016,地區醫院,Proteus mirabilis,Levofloxacin,15551,9343,4768,4575,182
2016,地區醫院,Proteus mirabilis,Meropenem,15551,8232,7493,739,182
2016,地區醫院,Pseudomonas aeruginosa,Amikacin,29439,24569,22301,2268,183
2016,地區醫院,Pseudomonas aeruginosa,Cefepime,29439,20793,16086,4707,183
2016,地區醫院,Pseudomonas aeruginosa,Ciprofloxacin,29439,22396,11915,10481,186
2016,地區醫院,Pseudomonas aeruginosa,Ceftazidime,29439,26450,21078,5372,186
2016,地區醫院,Pseudomonas aeruginosa,Gentamicin,29439,26406,17223,9183,186
2016,地區醫院,Pseudomonas aeruginosa,Imipenem,29439,21512,16244,5268,186
2016,地區醫院,Pseudomonas aeruginosa,Levofloxacin,29439,21175,10281,10894,186
2016,地區醫院,Pseudomonas aeruginosa,Meropenem,29439,17080,13009,4071,186
2016,地區醫院,Pseudomonas aeruginosa,Piperacillin/Tazobactam,29439,24600,18369,6231,186
2016,地區醫院,Pseudomonas aeruginosa,Piperacillin,29439,9570,5943,3627,186
2016,地區醫院,Enterococcus faecalis,Ampicillin,4761,3365,3221,144,169
2016,地區醫院,Enterococcus faecalis,Gentamicin-High,4761,3240,1349,1891,169
2016,地區醫院,Enterococcus faecalis,Vancomycin,4761,4707,4599,108,174
2016,地區醫院,Enterococcus faecium,Ampicillin,2114,1650,150,1500,167
2016,地區醫院,Enterococcus faecium,Gentamicin-High,2114,1561,580,981,168
2016,地區醫院,Enterococcus faecium,Vancomycin,2114,2081,1068,1013,174
2016,地區醫院,Staphylococcus aureus,Ciprofloxacin,26886,8927,5518,3409,190
2016,地區醫院,Staphylococcus aureus,Oxacillin,26886,25782,10202,15580,201
2016,地區醫院,Staphylococcus aureus,Trimethoprim/Sulfamethoxazole,26886,18520,15467,3053,193
2016,地區醫院,Staphylococcus aureus,Vancomycin,26886,23383,22871,512,197
2016,地區醫院,Enterococcus spp.,Ampicillin,7018,3861,2737,1124,180
2016,地區醫院,Enterococcus spp.,Gentamicin-High,7018,3663,1665,1998,178
2016,地區醫院,Enterococcus spp.,Vancomycin,7018,6823,5842,981,188
2015,醫學中心,Acinetobacter baumannii,Ampicillin/Sulbactam,24121,15448,7961,7487,16
2015,醫學中心,Acinetobacter baumannii,Amikacin,24121,11620,4629,6991,16
2015,醫學中心,Acinetobacter baumannii,Cefepime,24121,16025,6357,9668,16
2015,醫學中心,Acinetobacter baumannii,Ciprofloxacin,24121,16535,6013,10522,16
2015,醫學中心,Acinetobacter baumannii,Ceftazidime,24121,16534,6520,10014,16
2015,醫學中心,Acinetobacter baumannii,Colistin,24121,8457,8340,117,16
2015,醫學中心,Acinetobacter baumannii,Gentamicin,24121,14989,6085,8904,16
2015,醫學中心,Acinetobacter baumannii,Imipenem,24121,22567,9029,13538,22
2015,醫學中心,Acinetobacter baumannii,Levofloxacin,24121,11623,4418,7205,16
2015,醫學中心,Acinetobacter baumannii,Meropenem,24121,13950,6230,7720,21
2015,醫學中心,Acinetobacter baumannii,Piperacillin/Tazobactam,24121,14676,5375,9301,16
2015,醫學中心,Acinetobacter baumannii,Piperacillin,24121,1512,448,1064,16
2015,醫學中心,Acinetobacter baumannii,Tigecycline,24121,9243,6527,2716,16
2015,醫學中心,Enterobacter cloacae,Amikacin,8247,6247,6182,65,16
2015,醫學中心,Enterobacter cloacae,Cefotaxime,8247,3020,1808,1212,16
2015,醫學中心,Enterobacter cloacae,Cefepime,8247,5836,5077,759,16
2015,醫學中心,Enterobacter cloacae,Ciprofloxacin,8247,5699,4597,1102,16
2015,醫學中心,Enterobacter cloacae,Ceftazidime,8247,5798,3518,2280,16
2015,醫學中心,Enterobacter cloacae,Ceftriaxone,8247,5213,3092,2121,16
2015,醫學中心,Enterobacter cloacae,Ertapenem,8247,6819,5677,1142,16
2015,醫學中心,Enterobacter cloacae,Gentamicin,8247,6346,5264,1082,16
2015,醫學中心,Enterobacter cloacae,Imipenem,8247,5967,5344,623,16
2015,醫學中心,Enterobacter cloacae,Levofloxacin,8247,5104,4201,903,16
2015,醫學中心,Enterobacter cloacae,Meropenem,8247,2396,2243,153,16
2015,醫學中心,Escherichia coli,Ampicillin/Sulbactam,89052,43220,19849,23371,16
2015,醫學中心,Escherichia coli,Ampicillin,89052,33061,8360,24701,16
2015,醫學中心,Escherichia coli,Amikacin,89052,70751,70211,540,16
2015,醫學中心,Escherichia coli,Cefuroxime sodium,89052,13762,8828,4934,16
2015,醫學中心,Escherichia coli,Cefotaxime,89052,27130,19631,7499,16
2015,醫學中心,Escherichia coli,Ciprofloxacin,89052,66632,42540,24092,16
2015,醫學中心,Escherichia coli,Ceftazidime,89052,38653,28910,9743,16
2015,醫學中心,Escherichia coli,Cefazolin,89052,43832,23765,20067,16
2015,醫學中心,Escherichia coli,Ceftriaxone,89052,47714,33204,14510,16
2015,醫學中心,Escherichia coli,Ertapenem,89052,59237,58390,847,16
2015,醫學中心,Escherichia coli,Gentamicin,89052,66539,50067,16472,16
2015,醫學中心,Escherichia coli,Imipenem,89052,47132,46822,310,16
2015,醫學中心,Escherichia coli,Levofloxacin,89052,59941,38379,21562,16
2015,醫學中心,Escherichia coli,Meropenem,89052,18172,18091,81,16
2015,醫學中心,Klebsiella pneumoniae,Ampicillin/Sulbactam,46690,22077,13099,8978,16
2015,醫學中心,Klebsiella pneumoniae,Ampicillin,46690,16757,2,16755,16
2015,醫學中心,Klebsiella pneumoniae,Amikacin,46690,32592,30436,2156,16
2015,醫學中心,Klebsiella pneumoniae,Cefuroxime sodium,46690,6681,3787,2894,16
2015,醫學中心,Klebsiella pneumoniae,Cefotaxime,46690,14147,9877,4270,16
2015,醫學中心,Klebsiella pneumoniae,Ciprofloxacin,46690,30179,21772,8407,16
2015,醫學中心,Klebsiella pneumoniae,Ceftazidime,46690,22018,14871,7147,17
2015,醫學中心,Klebsiella pneumoniae,Cefazolin,46690,21317,11598,9719,16
2015,醫學中心,Klebsiella pneumoniae,Ceftriaxone,46690,13002,9677,3325,16
2015,醫學中心,Klebsiella pneumoniae,Ertapenem,46690,40243,36297,3946,21
2015,醫學中心,Klebsiella pneumoniae,Gentamicin,46690,30482,22788,7694,16
2015,醫學中心,Klebsiella pneumoniae,Imipenem,46690,33950,31525,2425,22
2015,醫學中心,Klebsiella pneumoniae,Levofloxacin,46690,21594,15976,5618,16
2015,醫學中心,Klebsiella pneumoniae,Meropenem,46690,17107,16427,680,21
2015,醫學中心,Proteus mirabilis,Ampicillin/Sulbactam,9386,6902,4794,2108,16
2015,醫學中心,Proteus mirabilis,Ampicillin,9386,4723,1969,2754,16
2015,醫學中心,Proteus mirabilis,Amikacin,9386,7127,6912,215,16
2015,醫學中心,Proteus mirabilis,Cefuroxime sodium,9386,1681,1472,209,16
2015,醫學中心,Proteus mirabilis,Cefotaxime,9386,3792,3425,367,16
2015,醫學中心,Proteus mirabilis,Ciprofloxacin,9386,6377,4489,1888,16
2015,醫學中心,Proteus mirabilis,Cefazolin,9386,8430,4452,3978,16
2015,醫學中心,Proteus mirabilis,Ceftriaxone,9386,3772,3331,441,16
2015,醫學中心,Proteus mirabilis,Gentamicin,9386,8705,5878,2827,16
2015,醫學中心,Proteus mirabilis,Levofloxacin,9386,5796,4431,1365,16
2015,醫學中心,Proteus mirabilis,Meropenem,9386,2396,2296,100,16
2015,醫學中心,Pseudomonas aeruginosa,Amikacin,33714,22775,22101,674,16
2015,醫學中心,Pseudomonas aeruginosa,Cefepime,33714,21501,18342,3159,16
2015,醫學中心,Pseudomonas aeruginosa,Ciprofloxacin,33714,29367,23333,6034,16
2015,醫學中心,Pseudomonas aeruginosa,Ceftazidime,33714,30354,25989,4365,17
2015,醫學中心,Pseudomonas aeruginosa,Gentamicin,33714,28576,25129,3447,16
2015,醫學中心,Pseudomonas aeruginosa,Imipenem,33714,29416,24224,5192,16
2015,醫學中心,Pseudomonas aeruginosa,Levofloxacin,33714,27231,20596,6635,16
2015,醫學中心,Pseudomonas aeruginosa,Meropenem,33714,21418,18602,2816,17
2015,醫學中心,Pseudomonas aeruginosa,Piperacillin/Tazobactam,33714,28294,23750,4544,16
2015,醫學中心,Pseudomonas aeruginosa,Piperacillin,33714,9471,7655,1816,16
2015,醫學中心,Enterococcus faecalis,Ampicillin,20114,10068,9239,829,16
2015,醫學中心,Enterococcus faecalis,Gentamicin-High,20114,9792,5045,4747,16
2015,醫學中心,Enterococcus faecalis,Vancomycin,20114,20056,19951,105,22
2015,醫學中心,Enterococcus faecium,Ampicillin,13179,6163,530,5633,16
2015,醫學中心,Enterococcus faecium,Gentamicin-High,13179,7039,2933,4106,16
2015,醫學中心,Enterococcus faecium,Vancomycin,13179,13163,5743,7420,22
2015,醫學中心,Staphylococcus aureus,Ciprofloxacin,45806,13791,10056,3735,16
2015,醫學中心,Staphylococcus aureus,Oxacillin,45806,45120,22292,22828,22
2015,醫學中心,Staphylococcus aureus,Trimethoprim/Sulfamethoxazole,45806,29503,24499,5004,16
2015,醫學中心,Staphylococcus aureus,Vancomycin,45806,30195,30179,16,17
2015,醫學中心,Enterococcus spp.,Ampicillin,6188,5207,4019,1188,16
2015,醫學中心,Enterococcus spp.,Gentamicin-High,6188,5340,3641,1699,16
2015,醫學中心,Enterococcus spp.,Vancomycin,6188,6163,5593,570,21
2015,區域醫院,Acinetobacter baumannii,Ampicillin/Sulbactam,27170,21100,9030,12070,75
2015,區域醫院,Acinetobacter baumannii,Amikacin,27170,15858,6684,9174,75
2015,區域醫院,Acinetobacter baumannii,Cefepime,27170,20810,6358,14452,75
2015,區域醫院,Acinetobacter baumannii,Ciprofloxacin,27170,15380,4516,10864,75
2015,區域醫院,Acinetobacter baumannii,Ceftazidime,27170,22128,6370,15758,75
2015,區域醫院,Acinetobacter baumannii,Colistin,27170,8614,8447,167,74
2015,區域醫院,Acinetobacter baumannii,Gentamicin,27170,22083,6894,15189,75
2015,區域醫院,Acinetobacter baumannii,Imipenem,27170,21708,7898,13810,82
2015,區域醫院,Acinetobacter baumannii,Levofloxacin,27170,17472,5332,12140,75
2015,區域醫院,Acinetobacter baumannii,Meropenem,27170,15303,6201,9102,81
2015,區域醫院,Acinetobacter baumannii,Piperacillin/Tazobactam,27170,21392,5624,15768,75
2015,區域醫院,Acinetobacter baumannii,Piperacillin,27170,5977,823,5154,74
2015,區域醫院,Acinetobacter baumannii,Tigecycline,27170,11981,8742,3239,74
2015,區域醫院,Enterobacter cloacae,Amikacin,9786,8202,7970,232,72
2015,區域醫院,Enterobacter cloacae,Cefotaxime,9786,3971,2457,1514,72
2015,區域醫院,Enterobacter cloacae,Cefepime,9786,7869,7196,673,72
2015,區域醫院,Enterobacter cloacae,Ciprofloxacin,9786,5979,5004,975,72
2015,區域醫院,Enterobacter cloacae,Ceftazidime,9786,7244,5129,2115,73
2015,區域醫院,Enterobacter cloacae,Ceftriaxone,9786,7138,4868,2270,73
2015,區域醫院,Enterobacter cloacae,Ertapenem,9786,7648,6820,828,75
2015,區域醫院,Enterobacter cloacae,Gentamicin,9786,8600,7440,1160,72
2015,區域醫院,Enterobacter cloacae,Imipenem,9786,5939,5479,460,74
2015,區域醫院,Enterobacter cloacae,Levofloxacin,9786,6617,5871,746,72
2015,區域醫院,Enterobacter cloacae,Meropenem,9786,4883,4785,98,74
2015,區域醫院,Escherichia coli,Ampicillin/Sulbactam,137201,108674,53681,54993,72
2015,區域醫院,Escherichia coli,Ampicillin,137201,64404,16567,47837,72
2015,區域醫院,Escherichia coli,Amikacin,137201,123512,121372,2140,73
2015,區域醫院,Escherichia coli,Cefuroxime sodium,137201,36330,24566,11764,72
2015,區域醫院,Escherichia coli,Cefotaxime,137201,55308,37726,17582,72
2015,區域醫院,Escherichia coli,Ciprofloxacin,137201,92458,58884,33574,73
2015,區域醫院,Escherichia coli,Ceftazidime,137201,92309,70303,22006,73
2015,區域醫院,Escherichia coli,Cefazolin,137201,110560,59257,51303,72
2015,區域醫院,Escherichia coli,Ceftriaxone,137201,96216,67300,28916,73
2015,區域醫院,Escherichia coli,Ertapenem,137201,104309,102327,1982,75
2015,區域醫院,Escherichia coli,Gentamicin,137201,129439,96426,33013,73
2015,區域醫院,Escherichia coli,Imipenem,137201,83329,81458,1871,76
2015,區域醫院,Escherichia coli,Levofloxacin,137201,101614,65097,36517,73
2015,區域醫院,Escherichia coli,Meropenem,137201,60131,59536,595,75
2015,區域醫院,Klebsiella pneumoniae,Ampicillin/Sulbactam,60463,42404,24933,17471,74
2015,區域醫院,Klebsiella pneumoniae,Ampicillin,60463,23362,626,22736,74
2015,區域醫院,Klebsiella pneumoniae,Amikacin,60463,49652,46244,3408,75
2015,區域醫院,Klebsiella pneumoniae,Cefuroxime sodium,60463,12396,7582,4814,74
2015,區域醫院,Klebsiella pneumoniae,Cefotaxime,60463,23410,14102,9308,74
2015,區域醫院,Klebsiella pneumoniae,Ciprofloxacin,60463,39346,27403,11943,75
2015,區域醫院,Klebsiella pneumoniae,Ceftazidime,60463,39758,27891,11867,75
2015,區域醫院,Klebsiella pneumoniae,Cefazolin,60463,44681,24171,20510,74
2015,區域醫院,Klebsiella pneumoniae,Ceftriaxone,60463,33859,24950,8909,74
2015,區域醫院,Klebsiella pneumoniae,Ertapenem,60463,41604,36582,5022,79
2015,區域醫院,Klebsiella pneumoniae,Gentamicin,60463,52543,39086,13457,75
2015,區域醫院,Klebsiella pneumoniae,Imipenem,60463,38923,36122,2801,82
2015,區域醫院,Klebsiella pneumoniae,Levofloxacin,60463,35574,26216,9358,74
2015,區域醫院,Klebsiella pneumoniae,Meropenem,60463,25959,24756,1203,81
2015,區域醫院,Proteus mirabilis,Ampicillin/Sulbactam,20925,17757,11201,6556,73
2015,區域醫院,Proteus mirabilis,Ampicillin,20925,11242,3322,7920,72
2015,區域醫院,Proteus mirabilis,Amikacin,20925,16422,15133,1289,72
2015,區域醫院,Proteus mirabilis,Cefuroxime sodium,20925,5282,4083,1199,72
2015,區域醫院,Proteus mirabilis,Cefotaxime,20925,9241,7028,2213,72
2015,區域醫院,Proteus mirabilis,Ciprofloxacin,20925,13433,8637,4796,72
2015,區域醫院,Proteus mirabilis,Cefazolin,20925,18894,7906,10988,73
2015,區域醫院,Proteus mirabilis,Ceftriaxone,20925,12592,10786,1806,72
2015,區域醫院,Proteus mirabilis,Gentamicin,20925,19790,11498,8292,73
2015,區域醫院,Proteus mirabilis,Levofloxacin,20925,13025,9251,3774,72
2015,區域醫院,Proteus mirabilis,Meropenem,20925,8944,8793,151,74
2015,區域醫院,Pseudomonas aeruginosa,Amikacin,53067,42876,40849,2027,72
2015,區域醫院,Pseudomonas aeruginosa,Cefepime,53067,42494,36799,5695,72
2015,區域醫院,Pseudomonas aeruginosa,Ciprofloxacin,53067,38499,28096,10403,73
2015,區域醫院,Pseudomonas aeruginosa,Ceftazidime,53067,48921,42745,6176,73
2015,區域醫院,Pseudomonas aeruginosa,Gentamicin,53067,48719,40179,8540,73
2015,區域醫院,Pseudomonas aeruginosa,Imipenem,53067,39821,33809,6012,75
2015,區域醫院,Pseudomonas aeruginosa,Levofloxacin,53067,41701,29947,11754,73
2015,區域醫院,Pseudomonas aeruginosa,Meropenem,53067,35078,30294,4784,76
2015,區域醫院,Pseudomonas aeruginosa,Piperacillin/Tazobactam,53067,48722,40814,7908,73
2015,區域醫院,Pseudomonas aeruginosa,Piperacillin,53067,18416,13325,5091,73
2015,區域醫院,Enterococcus faecalis,Ampicillin,19723,12992,12024,968,72
2015,區域醫院,Enterococcus faecalis,Gentamicin-High,19723,14750,7500,7250,71
2015,區域醫院,Enterococcus faecalis,Vancomycin,19723,19354,19121,233,79
2015,區域醫院,Enterococcus faecium,Ampicillin,8643,5562,708,4854,72
2015,區域醫院,Enterococcus faecium,Gentamicin-High,8643,6354,2477,3877,71
2015,區域醫院,Enterococcus faecium,Vancomycin,8643,8163,4304,3859,79
2015,區域醫院,Staphylococcus aureus,Ciprofloxacin,54104,16662,9875,6787,74
2015,區域醫院,Staphylococcus aureus,Oxacillin,54104,52376,24315,28061,82
2015,區域醫院,Staphylococcus aureus,Trimethoprim/Sulfamethoxazole,54104,45060,38103,6957,75
2015,區域醫院,Staphylococcus aureus,Vancomycin,54104,43363,43107,256,76
2015,區域醫院,Enterococcus spp.,Ampicillin,12570,9434,7135,2299,70
2015,區域醫院,Enterococcus spp.,Gentamicin-High,12570,9990,5624,4366,69
2015,區域醫院,Enterococcus spp.,Vancomycin,12570,12445,10831,1614,74
2015,地區醫院,Acinetobacter baumannii,Ampicillin/Sulbactam,16819,9622,3004,6618,184
2015,地區醫院,Acinetobacter baumannii,Amikacin,16819,9862,2265,7597,184
2015,地區醫院,Acinetobacter baumannii,Cefepime,16819,8865,1200,7665,184
2015,地區醫院,Acinetobacter baumannii,Ciprofloxacin,16819,9292,908,8384,184
2015,地區醫院,Acinetobacter baumannii,Ceftazidime,16819,11560,2202,9358,184
2015,地區醫院,Acinetobacter baumannii,Colistin,16819,4710,4592,118,182
2015,地區醫院,Acinetobacter baumannii,Gentamicin,16819,11737,2404,9333,184
2015,地區醫院,Acinetobacter baumannii,Imipenem,16819,13944,3658,10286,194
2015,地區醫院,Acinetobacter baumannii,Levofloxacin,16819,8483,837,7646,183
2015,地區醫院,Acinetobacter baumannii,Meropenem,16819,7372,1537,5835,190
2015,地區醫院,Acinetobacter baumannii,Piperacillin/Tazobactam,16819,9839,1366,8473,184
2015,地區醫院,Acinetobacter baumannii,Piperacillin,16819,2138,208,1930,183
2015,地區醫院,Acinetobacter baumannii,Tigecycline,16819,5237,4100,1137,183
2015,地區醫院,Enterobacter cloacae,Amikacin,2690,2236,2132,104,170
2015,地區醫院,Enterobacter cloacae,Cefotaxime,2690,820,599,221,169
2015,地區醫院,Enterobacter cloacae,Cefepime,2690,1463,1320,143,170
2015,地區醫院,Enterobacter cloacae,Ciprofloxacin,2690,1717,1341,376,170
2015,地區醫院,Enterobacter cloacae,Ceftazidime,2690,1927,1560,367,171
2015,地區醫院,Enterobacter cloacae,Ceftriaxone,2690,1785,1329,456,170
2015,地區醫院,Enterobacter cloacae,Ertapenem,2690,1343,1225,118,171
2015,地區醫院,Enterobacter cloacae,Gentamicin,2690,2406,1967,439,170
2015,地區醫院,Enterobacter cloacae,Imipenem,2690,1839,1760,79,171
2015,地區醫院,Enterobacter cloacae,Levofloxacin,2690,1622,1274,348,170
2015,地區醫院,Enterobacter cloacae,Meropenem,2690,997,952,45,170
2015,地區醫院,Escherichia coli,Ampicillin/Sulbactam,57740,29189,12765,16424,179
2015,地區醫院,Escherichia coli,Ampicillin,57740,26799,6517,20282,180
2015,地區醫院,Escherichia coli,Amikacin,57740,43736,41949,1787,181
2015,地區醫院,Escherichia coli,Cefuroxime sodium,57740,10068,5617,4451,179
2015,地區醫院,Escherichia coli,Cefotaxime,57740,17298,11190,6108,179
2015,地區醫院,Escherichia coli,Ciprofloxacin,57740,38406,20245,18161,181
2015,地區醫院,Escherichia coli,Ceftazidime,57740,36709,24472,12237,181
2015,地區醫院,Escherichia coli,Cefazolin,57740,42444,19169,23275,180
2015,地區醫院,Escherichia coli,Ceftriaxone,57740,34018,21250,12768,180
2015,地區醫院,Escherichia coli,Ertapenem,57740,30277,28638,1639,181
2015,地區醫院,Escherichia coli,Gentamicin,57740,48892,33174,15718,181
2015,地區醫院,Escherichia coli,Imipenem,57740,33186,31548,1638,182
2015,地區醫院,Escherichia coli,Levofloxacin,57740,30230,16822,13408,181
2015,地區醫院,Escherichia coli,Meropenem,57740,25188,23796,1392,181
2015,地區醫院,Klebsiella pneumoniae,Ampicillin/Sulbactam,28787,13560,5767,7793,184
2015,地區醫院,Klebsiella pneumoniae,Ampicillin,28787,11315,861,10454,186
2015,地區醫院,Klebsiella pneumoniae,Amikacin,28787,19903,17047,2856,185
2015,地區醫院,Klebsiella pneumoniae,Cefuroxime sodium,28787,5742,2782,2960,184
2015,地區醫院,Klebsiella pneumoniae,Cefotaxime,28787,7684,4514,3170,184
2015,地區醫院,Klebsiella pneumoniae,Ciprofloxacin,28787,17138,9766,7372,185
2015,地區醫院,Klebsiella pneumoniae,Ceftazidime,28787,17778,10361,7417,186
2015,地區醫院,Klebsiella pneumoniae,Cefazolin,28787,18802,8591,10211,184
2015,地區醫院,Klebsiella pneumoniae,Ceftriaxone,28787,14962,9209,5753,184
2015,地區醫院,Klebsiella pneumoniae,Ertapenem,28787,16352,14061,2291,193
2015,地區醫院,Klebsiella pneumoniae,Gentamicin,28787,22128,14550,7578,185
2015,地區醫院,Klebsiella pneumoniae,Imipenem,28787,20306,18535,1771,195
2015,地區醫院,Klebsiella pneumoniae,Levofloxacin,28787,12283,7666,4617,184
2015,地區醫院,Klebsiella pneumoniae,Meropenem,28787,11255,10365,890,191
2015,地區醫院,Proteus mirabilis,Ampicillin/Sulbactam,15141,9774,4260,5514,179
2015,地區醫院,Proteus mirabilis,Ampicillin,15141,7713,1355,6358,179
2015,地區醫院,Proteus mirabilis,Amikacin,15141,12819,9774,3045,179
2015,地區醫院,Proteus mirabilis,Cefuroxime sodium,15141,3033,1946,1087,178
2015,地區醫院,Proteus mirabilis,Cefotaxime,15141,4888,3291,1597,178
2015,地區醫院,Proteus mirabilis,Ciprofloxacin,15141,10761,5072,5689,179
2015,地區醫院,Proteus mirabilis,Cefazolin,15141,11378,3291,8087,180
2015,地區醫院,Proteus mirabilis,Ceftriaxone,15141,9628,6921,2707,178
2015,地區醫院,Proteus mirabilis,Gentamicin,15141,14270,4963,9307,180
2015,地區醫院,Proteus mirabilis,Levofloxacin,15141,8317,4520,3797,178
2015,地區醫院,Proteus mirabilis,Meropenem,15141,7617,7078,539,179
2015,地區醫院,Pseudomonas aeruginosa,Amikacin,29718,24139,22067,2072,177
2015,地區醫院,Pseudomonas aeruginosa,Cefepime,29718,18956,14828,4128,177
2015,地區醫院,Pseudomonas aeruginosa,Ciprofloxacin,29718,21716,11006,10710,178
2015,地區醫院,Pseudomonas aeruginosa,Ceftazidime,29718,26044,20806,5238,178
2015,地區醫院,Pseudomonas aeruginosa,Gentamicin,29718,25702,16848,8854,178
2015,地區醫院,Pseudomonas aeruginosa,Imipenem,29718,21612,16955,4657,178
2015,地區醫院,Pseudomonas aeruginosa,Levofloxacin,29718,20031,9988,10043,178
2015,地區醫院,Pseudomonas aeruginosa,Meropenem,29718,16568,12764,3804,178
2015,地區醫院,Pseudomonas aeruginosa,Piperacillin/Tazobactam,29718,22481,17420,5061,178
2015,地區醫院,Pseudomonas aeruginosa,Piperacillin,29718,8705,6217,2488,178
2015,地區醫院,Enterococcus faecalis,Ampicillin,4275,2819,2565,254,166
2015,地區醫院,Enterococcus faecalis,Gentamicin-High,4275,2668,1150,1518,167
2015,地區醫院,Enterococcus faecalis,Vancomycin,4275,4024,3898,126,174
2015,地區醫院,Enterococcus faecium,Ampicillin,1762,1277,171,1106,163
2015,地區醫院,Enterococcus faecium,Gentamicin-High,1762,1237,413,824,162
2015,地區醫院,Enterococcus faecium,Vancomycin,1762,1651,930,721,170
2015,地區醫院,Staphylococcus aureus,Ciprofloxacin,25700,8819,5550,3269,184
2015,地區醫院,Staphylococcus aureus,Oxacillin,25700,24283,9685,14598,197
2015,地區醫院,Staphylococcus aureus,Trimethoprim/Sulfamethoxazole,25700,16236,13449,2787,186
2015,地區醫院,Staphylococcus aureus,Vancomycin,25700,20583,20314,269,192
2015,地區醫院,Enterococcus spp.,Ampicillin,6215,3217,2404,813,172
2015,地區醫院,Enterococcus spp.,Gentamicin-High,6215,3390,1765,1625,173
2015,地區醫院,Enterococcus spp.,Vancomycin,6215,6116,5372,744,184
2014,醫學中心,Acinetobacter baumannii,Ampicillin(SAM),25001,16962,8656,8306,15
2014,醫學中心,Acinetobacter baumannii,Amikacin,25001,12251,4981,7270,15
2014,醫學中心,Acinetobacter baumannii,Cefepime,25001,17163,6754,10409,15
2014,醫學中心,Acinetobacter baumannii,Ciprofloxacin,25001,17312,6499,10813,15
2014,醫學中心,Acinetobacter baumannii,Ceftazidime,25001,17307,6868,10439,15
2014,醫學中心,Acinetobacter baumannii,Colistin,25001,4453,4406,47,11
2014,醫學中心,Acinetobacter baumannii,Gentamicin,25001,15575,6649,8926,15
2014,醫學中心,Acinetobacter baumannii,Imipenem,25001,23950,9534,14416,21
2014,醫學中心,Acinetobacter baumannii,Levofloxacin,25001,11316,4920,6396,15
2014,醫學中心,Acinetobacter baumannii,Meropenem,25001,14484,6213,8271,20
2014,醫學中心,Acinetobacter baumannii,Piperacillin/Tazobactam,25001,16408,5890,10518,15
2014,醫學中心,Acinetobacter baumannii,Piperacillin,25001,2603,612,1991,11
2014,醫學中心,Enterobacter cloacae,Amikacin,8142,5605,5522,83,12
2014,醫學中心,Enterobacter cloacae,Cefotaxime,8142,3080,1960,1120,15
2014,醫學中心,Enterobacter cloacae,Cefepime,8142,5029,4554,475,12
2014,醫學中心,Enterobacter cloacae,Ciprofloxacin,8142,5080,4226,854,12
2014,醫學中心,Enterobacter cloacae,Ceftazidime,8142,5306,3201,2105,15
2014,醫學中心,Enterobacter cloacae,Ceftriaxone,8142,4920,2810,2110,14
2014,醫學中心,Enterobacter cloacae,Ertapenem,8142,7664,6344,1320,16
2014,醫學中心,Enterobacter cloacae,Gentamicin,8142,5606,4712,894,12
2014,醫學中心,Enterobacter cloacae,Imipenem,8142,5405,4967,438,16
2014,醫學中心,Enterobacter cloacae,Levofloxacin,8142,4781,4049,732,12
2014,醫學中心,Enterobacter cloacae,Meropenem,8142,2116,2050,66,17
2014,醫學中心,Escherichia coli,Ampicillin(SAM),80093,39808,17199,22609,12
2014,醫學中心,Escherichia coli,Ampicillin,80093,38390,9802,28588,12
2014,醫學中心,Escherichia coli,Amikacin,80093,73972,73263,709,15
2014,醫學中心,Escherichia coli,Cefuroxime,80093,15048,9854,5194,12
2014,醫學中心,Escherichia coli,Cefotaxime,80093,28527,20569,7958,15
2014,醫學中心,Escherichia coli,Ciprofloxacin,80093,68910,44040,24870,15
2014,醫學中心,Escherichia coli,Ceftazidime,80093,35762,26549,9213,15
2014,醫學中心,Escherichia coli,Cefazolin,80093,39726,19439,20287,12
2014,醫學中心,Escherichia coli,Ceftriaxone,80093,48162,33542,14620,14
2014,醫學中心,Escherichia coli,Ertapenem,80093,72803,71861,942,16
2014,醫學中心,Escherichia coli,Gentamicin,80093,73962,55276,18686,15
2014,醫學中心,Escherichia coli,Imipenem,80093,44561,44281,280,16
2014,醫學中心,Escherichia coli,Levofloxacin,80093,63149,41204,21945,15
2014,醫學中心,Escherichia coli,Meropenem,80093,15661,15608,53,16
2014,醫學中心,Klebsiella pneumoniae,Ampicillin(SAM),45183,19483,11775,7708,12
2014,醫學中心,Klebsiella pneumoniae,Amikacin,45183,31709,29965,1744,15
2014,醫學中心,Klebsiella pneumoniae,Cefuroxime,45183,7143,4310,2833,12
2014,醫學中心,Klebsiella pneumoniae,Cefotaxime,45183,13641,9873,3768,15
2014,醫學中心,Klebsiella pneumoniae,Ciprofloxacin,45183,29564,21552,8012,15
2014,醫學中心,Klebsiella pneumoniae,Ceftazidime,45183,20354,14113,6241,15
2014,醫學中心,Klebsiella pneumoniae,Cefazolin,45183,18538,9592,8946,12
2014,醫學中心,Klebsiella pneumoniae,Ceftriaxone,45183,10643,7823,2820,11
2014,醫學中心,Klebsiella pneumoniae,Ertapenem,45183,40201,36123,4078,20
2014,醫學中心,Klebsiella pneumoniae,Gentamicin,45183,31701,24345,7356,15
2014,醫學中心,Klebsiella pneumoniae,Imipenem,45183,29127,27234,1893,21
2014,醫學中心,Klebsiella pneumoniae,Levofloxacin,45183,19977,15118,4859,12
2014,醫學中心,Klebsiella pneumoniae,Meropenem,45183,12698,12135,563,20
2014,醫學中心,Proteus mirabilis,Ampicillin(SAM),10493,6945,4931,2014,15
2014,醫學中心,Proteus mirabilis,Ampicillin,10493,5884,2394,3490,15
2014,醫學中心,Proteus mirabilis,Amikacin,10493,6848,6624,224,12
2014,醫學中心,Proteus mirabilis,Cefuroxime,10493,1873,1619,254,12
2014,醫學中心,Proteus mirabilis,Cefotaxime,10493,4102,3748,354,12
2014,醫學中心,Proteus mirabilis,Ciprofloxacin,10493,6048,4182,1866,12
2014,醫學中心,Proteus mirabilis,Cefazolin,10493,8664,4210,4454,15
2014,醫學中心,Proteus mirabilis,Ceftriaxone,10493,3187,2809,378,11
2014,醫學中心,Proteus mirabilis,Gentamicin,10493,9678,6514,3164,15
2014,醫學中心,Proteus mirabilis,Levofloxacin,10493,5860,4524,1336,12
2014,醫學中心,Proteus mirabilis,Meropenem,10493,2319,2318,1,13
2014,醫學中心,Pseudomonas aeruginosa,Amikacin,33374,21024,20449,575,12
2014,醫學中心,Pseudomonas aeruginosa,Cefepime,33374,20019,17293,2726,12
2014,醫學中心,Pseudomonas aeruginosa,Ciprofloxacin,33374,30160,24119,6041,15
2014,醫學中心,Pseudomonas aeruginosa,Ceftazidime,33374,30163,25879,4284,15
2014,醫學中心,Pseudomonas aeruginosa,Gentamicin,33374,30125,26680,3445,15
2014,醫學中心,Pseudomonas aeruginosa,Imipenem,33374,29621,24845,4776,16
2014,醫學中心,Pseudomonas aeruginosa,Levofloxacin,33374,29405,22583,6822,15
2014,醫學中心,Pseudomonas aeruginosa,Meropenem,33374,22824,19779,3045,17
2014,醫學中心,Pseudomonas aeruginosa,Piperacillin/Tazobactam,33374,29646,24600,5046,15
2014,醫學中心,Pseudomonas aeruginosa,Piperacillin,33374,11894,9398,2496,14
2014,醫學中心,Enterococcus faecalis,Ampicillin,19107,9456,8633,823,15
2014,醫學中心,Enterococcus faecalis,Gentamicin-High,19107,6744,3570,3174,15
2014,醫學中心,Enterococcus faecalis,Vancomycin,19107,18988,18833,155,21
2014,醫學中心,Enterococcus faecium,Ampicillin,11931,6344,446,5898,15
2014,醫學中心,Enterococcus faecium,Gentamicin-High,11931,4974,2025,2949,15
2014,醫學中心,Enterococcus faecium,Vancomycin,11931,11916,6235,5681,21
2014,醫學中心,Staphylococcus aureus,Ciprofloxacin,45703,12909,9481,3428,16
2014,醫學中心,Staphylococcus aureus,Oxacillin,45703,45017,22278,22739,21
2014,醫學中心,Staphylococcus aureus,Trimethoprim/Sulfamethoxazole,45703,30635,25531,5104,15
2014,醫學中心,Staphylococcus aureus,Vancomycin,45703,30148,30129,19,16
2014,區域醫院,Acinetobacter baumannii,Ampicillin(SAM),29877,24191,9355,14836,75
2014,區域醫院,Acinetobacter baumannii,Amikacin,29877,19043,7953,11090,73
2014,區域醫院,Acinetobacter baumannii,Cefepime,29877,23541,6650,16891,75
2014,區域醫院,Acinetobacter baumannii,Ciprofloxacin,29877,18497,4808,13689,74
2014,區域醫院,Acinetobacter baumannii,Ceftazidime,29877,24516,7056,17460,75
2014,區域醫院,Acinetobacter baumannii,Colistin,29877,8604,8365,239,72
2014,區域醫院,Acinetobacter baumannii,Gentamicin,29877,23595,6923,16672,75
2014,區域醫院,Acinetobacter baumannii,Imipenem,29877,24022,8289,15733,81
2014,區域醫院,Acinetobacter baumannii,Levofloxacin,29877,17936,5075,12861,74
2014,區域醫院,Acinetobacter baumannii,Meropenem,29877,18140,6558,11582,79
2014,區域醫院,Acinetobacter baumannii,Piperacillin/Tazobactam,29877,23539,6040,17499,75
2014,區域醫院,Acinetobacter baumannii,Piperacillin,29877,8156,769,7387,72
2014,區域醫院,Enterobacter cloacae,Amikacin,9211,7438,7243,195,70
2014,區域醫院,Enterobacter cloacae,Cefotaxime,9211,3947,2462,1485,70
2014,區域醫院,Enterobacter cloacae,Cefepime,9211,7371,6583,788,71
2014,區域醫院,Enterobacter cloacae,Ciprofloxacin,9211,5814,4688,1126,70
2014,區域醫院,Enterobacter cloacae,Ceftazidime,9211,7175,5031,2144,70
2014,區域醫院,Enterobacter cloacae,Ceftriaxone,9211,6218,4388,1830,70
2014,區域醫院,Enterobacter cloacae,Ertapenem,9211,7025,6204,821,73
2014,區域醫院,Enterobacter cloacae,Gentamicin,9211,7725,6678,1047,71
2014,區域醫院,Enterobacter cloacae,Imipenem,9211,5811,5333,478,73
2014,區域醫院,Enterobacter cloacae,Levofloxacin,9211,5718,5089,629,69
2014,區域醫院,Enterobacter cloacae,Meropenem,9211,4467,4236,231,72
2014,區域醫院,Escherichia coli,Ampicillin(SAM),132087,94511,46227,48284,71
2014,區域醫院,Escherichia coli,Ampicillin,132087,79145,20563,58582,70
2014,區域醫院,Escherichia coli,Amikacin,132087,113736,110827,2909,71
2014,區域醫院,Escherichia coli,Cefuroxime,132087,41470,25470,16000,67
2014,區域醫院,Escherichia coli,Cefotaxime,132087,57604,38133,19471,70
2014,區域醫院,Escherichia coli,Ciprofloxacin,132087,94545,57340,37205,71
2014,區域醫院,Escherichia coli,Ceftazidime,132087,88844,67532,21312,70
2014,區域醫院,Escherichia coli,Cefazolin,132087,106404,56161,50243,70
2014,區域醫院,Escherichia coli,Ceftriaxone,132087,88791,63379,25412,70
2014,區域醫院,Escherichia coli,Ertapenem,132087,99249,94861,4388,73
2014,區域醫院,Escherichia coli,Gentamicin,132087,120031,88858,31173,72
2014,區域醫院,Escherichia coli,Imipenem,132087,82834,79048,3786,74
2014,區域醫院,Escherichia coli,Levofloxacin,132087,86779,56706,30073,70
2014,區域醫院,Escherichia coli,Meropenem,132087,56028,51973,4055,73
2014,區域醫院,Klebsiella pneumoniae,Ampicillin(SAM),62667,40867,23444,17423,74
2014,區域醫院,Klebsiella pneumoniae,Amikacin,62667,50077,45346,4731,74
2014,區域醫院,Klebsiella pneumoniae,Cefuroxime,62667,16322,9380,6942,70
2014,區域醫院,Klebsiella pneumoniae,Cefotaxime,62667,26295,16530,9765,73
2014,區域醫院,Klebsiella pneumoniae,Ciprofloxacin,62667,42937,28282,14655,74
2014,區域醫院,Klebsiella pneumoniae,Ceftazidime,62667,41242,28601,12641,73
2014,區域醫院,Klebsiella pneumoniae,Cefazolin,62667,46012,25363,20649,73
2014,區域醫院,Klebsiella pneumoniae,Ceftriaxone,62667,30998,23403,7595,72
2014,區域醫院,Klebsiella pneumoniae,Ertapenem,62667,44663,39057,5606,79
2014,區域醫院,Klebsiella pneumoniae,Gentamicin,62667,52595,38822,13773,75
2014,區域醫院,Klebsiella pneumoniae,Imipenem,62667,41834,37927,3907,80
2014,區域醫院,Klebsiella pneumoniae,Levofloxacin,62667,31687,23015,8672,72
2014,區域醫院,Klebsiella pneumoniae,Meropenem,62667,27466,24395,3071,79
2014,區域醫院,Proteus mirabilis,Ampicillin(SAM),20933,17381,11058,6323,72
2014,區域醫院,Proteus mirabilis,Ampicillin,20933,12480,3936,8544,71
2014,區域醫院,Proteus mirabilis,Amikacin,20933,16351,14893,1458,70
2014,區域醫院,Proteus mirabilis,Cefuroxime,20933,6986,5235,1751,67
2014,區域醫院,Proteus mirabilis,Cefotaxime,20933,10104,7661,2443,69
2014,區域醫院,Proteus mirabilis,Ciprofloxacin,20933,14476,9145,5331,70
2014,區域醫院,Proteus mirabilis,Cefazolin,20933,19470,7823,11647,71
2014,區域醫院,Proteus mirabilis,Ceftriaxone,20933,12226,10350,1876,69
2014,區域醫院,Proteus mirabilis,Gentamicin,20933,19523,11232,8291,72
2014,區域醫院,Proteus mirabilis,Levofloxacin,20933,11636,8550,3086,69
2014,區域醫院,Proteus mirabilis,Meropenem,20933,8448,7758,690,68
2014,區域醫院,Pseudomonas aeruginosa,Amikacin,51020,40638,38449,2189,70
2014,區域醫院,Pseudomonas aeruginosa,Cefepime,51020,42082,35544,6538,71
2014,區域醫院,Pseudomonas aeruginosa,Ciprofloxacin,51020,39138,28826,10312,71
2014,區域醫院,Pseudomonas aeruginosa,Ceftazidime,51020,48328,42091,6237,72
2014,區域醫院,Pseudomonas aeruginosa,Gentamicin,51020,46721,38346,8375,72
2014,區域醫院,Pseudomonas aeruginosa,Imipenem,51020,40036,34422,5614,71
2014,區域醫院,Pseudomonas aeruginosa,Levofloxacin,51020,39929,28698,11231,71
2014,區域醫院,Pseudomonas aeruginosa,Meropenem,51020,36258,30989,5269,73
2014,區域醫院,Pseudomonas aeruginosa,Piperacillin/Tazobactam,51020,48454,40571,7883,72
2014,區域醫院,Pseudomonas aeruginosa,Piperacillin,51020,22199,16854,5345,70
2014,區域醫院,Enterococcus faecalis,Ampicillin,16994,10850,10185,665,68
2014,區域醫院,Enterococcus faecalis,Gentamicin-High,16994,11574,5997,5577,69
2014,區域醫院,Enterococcus faecalis,Vancomycin,16994,16810,16677,133,76
2014,區域醫院,Enterococcus faecium,Ampicillin,7916,5364,791,4573,68
2014,區域醫院,Enterococcus faecium,Gentamicin-High,7916,5447,2099,3348,69
2014,區域醫院,Enterococcus faecium,Vancomycin,7916,7858,4780,3078,76
2014,區域醫院,Staphylococcus aureus,Ciprofloxacin,57544,18175,10931,7244,71
2014,區域醫院,Staphylococcus aureus,Oxacillin,57544,56144,25957,30187,83
2014,區域醫院,Staphylococcus aureus,Trimethoprim/Sulfamethoxazole,57544,47826,39178,8648,75
2014,區域醫院,Staphylococcus aureus,Vancomycin,57544,44593,44084,509,77
2014,地區醫院,Acinetobacter baumannii,Ampicillin(SAM),16788,9647,3207,6440,177
2014,地區醫院,Acinetobacter baumannii,Amikacin,16788,10892,3232,7660,179
2014,地區醫院,Acinetobacter baumannii,Cefepime,16788,8508,1588,6920,178
2014,地區醫院,Acinetobacter baumannii,Ciprofloxacin,16788,9794,1245,8549,178
2014,地區醫院,Acinetobacter baumannii,Ceftazidime,16788,12021,2642,9379,182
2014,地區醫院,Acinetobacter baumannii,Colistin,16788,3018,2954,64,173
2014,地區醫院,Acinetobacter baumannii,Gentamicin,16788,12103,2512,9591,180
2014,地區醫院,Acinetobacter baumannii,Imipenem,16788,14532,4179,10353,191
2014,地區醫院,Acinetobacter baumannii,Levofloxacin,16788,8235,1066,7169,177
2014,地區醫院,Acinetobacter baumannii,Meropenem,16788,7703,2063,5640,183
2014,地區醫院,Acinetobacter baumannii,Piperacillin/Tazobactam,16788,10090,1517,8573,180
2014,地區醫院,Acinetobacter baumannii,Piperacillin,16788,2671,220,2451,171
2014,地區醫院,Enterobacter cloacae,Amikacin,2620,2233,2037,196,167
2014,地區醫院,Enterobacter cloacae,Cefotaxime,2620,725,525,200,163
2014,地區醫院,Enterobacter cloacae,Cefepime,2620,1410,1315,95,166
2014,地區醫院,Enterobacter cloacae,Ciprofloxacin,2620,1662,1276,386,165
2014,地區醫院,Enterobacter cloacae,Ceftazidime,2620,2063,1646,417,170
2014,地區醫院,Enterobacter cloacae,Ceftriaxone,2620,1594,1163,431,170
2014,地區醫院,Enterobacter cloacae,Ertapenem,2620,1163,1092,71,168
2014,地區醫院,Enterobacter cloacae,Gentamicin,2620,2288,1774,514,167
2014,地區醫院,Enterobacter cloacae,Imipenem,2620,2060,2027,33,169
2014,地區醫院,Enterobacter cloacae,Levofloxacin,2620,1406,1102,304,163
2014,地區醫院,Enterobacter cloacae,Meropenem,2620,1005,918,87,170
2014,地區醫院,Escherichia coli,Ampicillin(SAM),53351,26783,11609,15174,170
2014,地區醫院,Escherichia coli,Ampicillin,53351,22049,5236,16813,170
2014,地區醫院,Escherichia coli,Amikacin,53351,45188,42810,2378,177
2014,地區醫院,Escherichia coli,Cefuroxime,53351,8952,4877,4075,167
2014,地區醫院,Escherichia coli,Cefotaxime,53351,15987,10666,5321,170
2014,地區醫院,Escherichia coli,Ciprofloxacin,53351,38621,20715,17906,174
2014,地區醫院,Escherichia coli,Ceftazidime,53351,37773,25442,12331,175
2014,地區醫院,Escherichia coli,Cefazolin,53351,38263,18172,20091,172
2014,地區醫院,Escherichia coli,Ceftriaxone,53351,33105,21040,12065,175
2014,地區醫院,Escherichia coli,Ertapenem,53351,26111,24565,1546,177
2014,地區醫院,Escherichia coli,Gentamicin,53351,48485,32386,16099,177
2014,地區醫院,Escherichia coli,Imipenem,53351,33239,32294,945,178
2014,地區醫院,Escherichia coli,Levofloxacin,53351,29299,16121,13178,172
2014,地區醫院,Escherichia coli,Meropenem,53351,21041,19618,1423,172
2014,地區醫院,Klebsiella pneumoniae,Ampicillin(SAM),28064,11921,5240,6681,175
2014,地區醫院,Klebsiella pneumoniae,Amikacin,28064,20803,17815,2988,182
2014,地區醫院,Klebsiella pneumoniae,Cefuroxime,28064,5354,2343,3011,173
2014,地區醫院,Klebsiella pneumoniae,Cefotaxime,28064,6979,4106,2873,175
2014,地區醫院,Klebsiella pneumoniae,Ciprofloxacin,28064,17185,9710,7475,180
2014,地區醫院,Klebsiella pneumoniae,Ceftazidime,28064,18775,11065,7710,181
2014,地區醫院,Klebsiella pneumoniae,Cefazolin,28064,17299,8334,8965,178
2014,地區醫院,Klebsiella pneumoniae,Ceftriaxone,28064,13013,8110,4903,176
2014,地區醫院,Klebsiella pneumoniae,Ertapenem,28064,14954,13071,1883,189
2014,地區醫院,Klebsiella pneumoniae,Gentamicin,28064,22309,14652,7657,182
2014,地區醫院,Klebsiella pneumoniae,Imipenem,28064,20981,19727,1254,191
2014,地區醫院,Klebsiella pneumoniae,Levofloxacin,28064,11614,7218,4396,173
2014,地區醫院,Klebsiella pneumoniae,Meropenem,28064,10675,9703,972,183
2014,地區醫院,Proteus mirabilis,Ampicillin(SAM),15291,8731,3734,4997,172
2014,地區醫院,Proteus mirabilis,Ampicillin,15291,7444,1333,6111,172
2014,地區醫院,Proteus mirabilis,Amikacin,15291,12133,9302,2831,173
2014,地區醫院,Proteus mirabilis,Cefuroxime,15291,2482,1491,991,166
2014,地區醫院,Proteus mirabilis,Cefotaxime,15291,4264,2819,1445,166
2014,地區醫院,Proteus mirabilis,Ciprofloxacin,15291,9686,4825,4861,169
2014,地區醫院,Proteus mirabilis,Cefazolin,15291,11131,3471,7660,175
2014,地區醫院,Proteus mirabilis,Ceftriaxone,15291,8301,5922,2379,170
2014,地區醫院,Proteus mirabilis,Gentamicin,15291,14241,5164,9077,177
2014,地區醫院,Proteus mirabilis,Levofloxacin,15291,7748,4400,3348,167
2014,地區醫院,Proteus mirabilis,Meropenem,15291,6999,6479,520,169
2014,地區醫院,Pseudomonas aeruginosa,Amikacin,28550,22510,20466,2044,171
2014,地區醫院,Pseudomonas aeruginosa,Cefepime,28550,16468,13302,3166,169
2014,地區醫院,Pseudomonas aeruginosa,Ciprofloxacin,28550,22350,11909,10441,174
2014,地區醫院,Pseudomonas aeruginosa,Ceftazidime,28550,26936,21821,5115,176
2014,地區醫院,Pseudomonas aeruginosa,Gentamicin,28550,26903,17576,9327,175
2014,地區醫院,Pseudomonas aeruginosa,Imipenem,28550,23010,18295,4715,173
2014,地區醫院,Pseudomonas aeruginosa,Levofloxacin,28550,19982,9798,10184,173
2014,地區醫院,Pseudomonas aeruginosa,Meropenem,28550,16612,12946,3666,172
2014,地區醫院,Pseudomonas aeruginosa,Piperacillin/Tazobactam,28550,23975,18948,5027,174
2014,地區醫院,Pseudomonas aeruginosa,Piperacillin,28550,10435,7798,2637,172
2014,地區醫院,Enterococcus faecalis,Ampicillin,3740,2596,2380,216,167
2014,地區醫院,Enterococcus faecalis,Gentamicin-High,3740,2572,1141,1431,167
2014,地區醫院,Enterococcus faecalis,Vancomycin,3740,3590,3532,58,176
2014,地區醫院,Enterococcus faecium,Ampicillin,1708,1242,161,1081,164
2014,地區醫院,Enterococcus faecium,Gentamicin-High,1708,1185,340,845,164
2014,地區醫院,Enterococcus faecium,Vancomycin,1708,1660,1140,520,174
2014,地區醫院,Staphylococcus aureus,Ciprofloxacin,24793,8627,5414,3213,183
2014,地區醫院,Staphylococcus aureus,Oxacillin,24793,23412,9565,13847,198
2014,地區醫院,Staphylococcus aureus,Trimethoprim/Sulfamethoxazole,24793,14954,12354,2600,184
2014,地區醫院,Staphylococcus aureus,Vancomycin,24793,20452,19947,505,191
2013,醫學中心,Acinetobacter baumannii,Ampicillin(SAM),25310,17892,8625,9267,16
2013,醫學中心,Acinetobacter baumannii,Amikacin,25310,13985,5734,8251,15
2013,醫學中心,Acinetobacter baumannii,Cefepime,25310,18027,6913,11114,16
2013,醫學中心,Acinetobacter baumannii,Ciprofloxacin,25310,17917,6418,11499,16
2013,醫學中心,Acinetobacter baumannii,Ceftazidime,25310,18243,7319,10924,16
2013,醫學中心,Acinetobacter baumannii,Gentamicin,25310,16414,6278,10136,15
2013,醫學中心,Acinetobacter baumannii,Imipenem,25310,23602,9686,13916,21
2013,醫學中心,Acinetobacter baumannii,Levofloxacin,25310,9820,4391,5429,15
2013,醫學中心,Acinetobacter baumannii,Meropenem,25310,14610,5949,8661,20
2013,醫學中心,Acinetobacter baumannii,Piperacillin/Tazobactam,25310,17429,5977,11452,16
2013,醫學中心,Acinetobacter baumannii,Piperacillin,25310,3193,907,2286,11
2013,醫學中心,Enterobacter cloacae,Amikacin,7994,4387,4336,51,12
2013,醫學中心,Enterobacter cloacae,Cefotaxime,7994,3745,2427,1318,15
2013,醫學中心,Enterobacter cloacae,Cefepime,7994,3835,3441,394,12
2013,醫學中心,Enterobacter cloacae,Ciprofloxacin,7994,3804,3119,685,12
2013,醫學中心,Enterobacter cloacae,Ceftazidime,7994,5085,2975,2110,14
2013,醫學中心,Enterobacter cloacae,Ceftriaxone,7994,4451,2589,1862,13
2013,醫學中心,Enterobacter cloacae,Ertapenem,7994,7721,6734,987,15
2013,醫學中心,Enterobacter cloacae,Gentamicin,7994,4340,3622,718,12
2013,醫學中心,Enterobacter cloacae,Imipenem,7994,4768,4403,365,15
2013,醫學中心,Enterobacter cloacae,Levofloxacin,7994,3155,2660,495,11
2013,醫學中心,Enterobacter cloacae,Meropenem,7994,2574,2522,52,15
2013,醫學中心,Escherichia coli,Ampicillin(SAM),74972,32839,14535,18304,11
2013,醫學中心,Escherichia coli,Ampicillin,74972,34727,10239,24488,12
2013,醫學中心,Escherichia coli,Amikacin,74972,74045,73449,596,15
2013,醫學中心,Escherichia coli,Cefuroxime,74972,10994,7263,3731,11
2013,醫學中心,Escherichia coli,Cefotaxime,74972,30613,22895,7718,15
2013,醫學中心,Escherichia coli,Ciprofloxacin,74972,68941,44726,24215,15
2013,醫學中心,Escherichia coli,Ceftazidime,74972,35749,26689,9060,14
2013,醫學中心,Escherichia coli,Cefazolin,74972,35270,20996,14274,12
2013,醫學中心,Escherichia coli,Ceftriaxone,74972,46774,34033,12741,13
2013,醫學中心,Escherichia coli,Ertapenem,74972,71523,70758,765,15
2013,醫學中心,Escherichia coli,Gentamicin,74972,74176,55532,18644,15
2013,醫學中心,Escherichia coli,Imipenem,74972,40749,40528,221,15
2013,醫學中心,Escherichia coli,Levofloxacin,74972,60458,39817,20641,14
2013,醫學中心,Escherichia coli,Meropenem,74972,19682,19604,78,15
2013,醫學中心,Klebsiella pneumoniae,Ampicillin(SAM),47154,15598,9940,5658,11
2013,醫學中心,Klebsiella pneumoniae,Amikacin,47154,31185,29370,1815,15
2013,醫學中心,Klebsiella pneumoniae,Cefuroxime,47154,5169,3301,1868,11
2013,醫學中心,Klebsiella pneumoniae,Cefotaxime,47154,15240,11499,3741,15
2013,醫學中心,Klebsiella pneumoniae,Ciprofloxacin,47154,28807,21092,7715,15
2013,醫學中心,Klebsiella pneumoniae,Ceftazidime,47154,19343,13918,5425,14
2013,醫學中心,Klebsiella pneumoniae,Cefazolin,47154,16361,9714,6647,12
2013,醫學中心,Klebsiella pneumoniae,Ceftriaxone,47154,7175,5774,1401,10
2013,醫學中心,Klebsiella pneumoniae,Ertapenem,47154,39177,36144,3033,20
2013,醫學中心,Klebsiella pneumoniae,Gentamicin,47154,31248,25055,6193,15
2013,醫學中心,Klebsiella pneumoniae,Imipenem,47154,24740,23614,1126,21
2013,醫學中心,Klebsiella pneumoniae,Levofloxacin,47154,15670,12029,3641,11
2013,醫學中心,Klebsiella pneumoniae,Meropenem,47154,13677,13301,376,20
2013,醫學中心,Proteus mirabilis,Ampicillin(SAM),9931,6901,5041,1860,14
2013,醫學中心,Proteus mirabilis,Ampicillin,9931,8149,3334,4815,15
2013,醫學中心,Proteus mirabilis,Amikacin,9931,5728,5536,192,12
2013,醫學中心,Proteus mirabilis,Cefuroxime,9931,1333,1179,154,11
2013,醫學中心,Proteus mirabilis,Cefotaxime,9931,3978,3639,339,12
2013,醫學中心,Proteus mirabilis,Ciprofloxacin,9931,4862,3498,1364,12
2013,醫學中心,Proteus mirabilis,Cefazolin,9931,9265,4925,4340,15
2013,醫學中心,Proteus mirabilis,Ceftriaxone,9931,2206,2035,171,10
2013,醫學中心,Proteus mirabilis,Gentamicin,9931,9735,6451,3284,15
2013,醫學中心,Proteus mirabilis,Levofloxacin,9931,4663,3650,1013,11
2013,醫學中心,Pseudomonas aeruginosa,Amikacin,33648,19058,18444,614,12
2013,醫學中心,Pseudomonas aeruginosa,Cefepime,33648,18188,15564,2624,12
2013,醫學中心,Pseudomonas aeruginosa,Ciprofloxacin,33648,33579,26634,6945,15
2013,醫學中心,Pseudomonas aeruginosa,Ceftazidime,33648,33601,28308,5293,15
2013,醫學中心,Pseudomonas aeruginosa,Gentamicin,33648,32472,28318,4154,15
2013,醫學中心,Pseudomonas aeruginosa,Imipenem,33648,32792,27292,5500,15
2013,醫學中心,Pseudomonas aeruginosa,Levofloxacin,33648,22171,17071,5100,15
2013,醫學中心,Pseudomonas aeruginosa,Meropenem,33648,25046,21746,3300,15
2013,醫學中心,Pseudomonas aeruginosa,Piperacillin/Tazobactam,33648,33323,27820,5503,15
2013,醫學中心,Pseudomonas aeruginosa,Piperacillin,33648,14122,11109,3013,13
2013,醫學中心,Enterococcus faecalis,Ampicillin,16567,9218,8811,407,14
2013,醫學中心,Enterococcus faecalis,Gentamicin-High,16567,4223,2439,1784,15
2013,醫學中心,Enterococcus faecalis,Vancomycin,16567,16537,16472,65,21
2013,醫學中心,Enterococcus faecium,Ampicillin,9377,5366,481,4885,14
2013,醫學中心,Enterococcus faecium,Gentamicin-High,9377,2766,1005,1761,15
2013,醫學中心,Enterococcus faecium,Vancomycin,9377,9245,5398,3847,21
2013,醫學中心,Staphylococcus aureus,Ciprofloxacin,47350,14628,10283,4345,14
2013,醫學中心,Staphylococcus aureus,Oxacillin,47350,46645,22642,24003,21
2013,醫學中心,Staphylococcus aureus,Trimethoprim/Sulfamethoxazole,47350,32011,25606,6405,15
2013,醫學中心,Staphylococcus aureus,Vancomycin,47350,29856,29433,423,16
2013,區域醫院,Acinetobacter baumannii,Ampicillin(SAM),31478,25136,9477,15659,73
2013,區域醫院,Acinetobacter baumannii,Amikacin,31478,21831,8492,13339,73
2013,區域醫院,Acinetobacter baumannii,Cefepime,31478,24207,6773,17434,75
2013,區域醫院,Acinetobacter baumannii,Ciprofloxacin,31478,22178,5635,16543,75
2013,區域醫院,Acinetobacter baumannii,Ceftazidime,31478,26831,7580,19251,75
2013,區域醫院,Acinetobacter baumannii,Gentamicin,31478,25100,7008,18092,75
2013,區域醫院,Acinetobacter baumannii,Imipenem,31478,25067,9035,16032,81
2013,區域醫院,Acinetobacter baumannii,Levofloxacin,31478,18425,4760,13665,73
2013,區域醫院,Acinetobacter baumannii,Meropenem,31478,19744,6874,12870,77
2013,區域醫院,Acinetobacter baumannii,Piperacillin/Tazobactam,31478,26009,6422,19587,75
2013,區域醫院,Acinetobacter baumannii,Piperacillin,31478,7870,767,7103,71
2013,區域醫院,Enterobacter cloacae,Amikacin,9270,5538,5387,151,67
2013,區域醫院,Enterobacter cloacae,Cefotaxime,9270,5099,3346,1753,66
2013,區域醫院,Enterobacter cloacae,Cefepime,9270,5580,5089,491,68
2013,區域醫院,Enterobacter cloacae,Ciprofloxacin,9270,4805,3992,813,66
2013,區域醫院,Enterobacter cloacae,Ceftazidime,9270,6362,4535,1827,68
2013,區域醫院,Enterobacter cloacae,Ceftriaxone,9270,5462,3882,1580,69
2013,區域醫院,Enterobacter cloacae,Ertapenem,9270,6469,5902,567,69
2013,區域醫院,Enterobacter cloacae,Gentamicin,9270,5711,4875,836,68
2013,區域醫院,Enterobacter cloacae,Imipenem,9270,5747,5378,369,68
2013,區域醫院,Enterobacter cloacae,Levofloxacin,9270,3660,3220,440,66
2013,區域醫院,Enterobacter cloacae,Meropenem,9270,3913,3654,259,67
2013,區域醫院,Escherichia coli,Ampicillin(SAM),129199,65926,31825,34101,68
2013,區域醫院,Escherichia coli,Ampicillin,129199,62897,16909,45988,66
2013,區域醫院,Escherichia coli,Amikacin,129199,111146,107729,3417,69
2013,區域醫院,Escherichia coli,Cefuroxime,129199,38174,25835,12339,63
2013,區域醫院,Escherichia coli,Cefotaxime,129199,63820,44857,18963,66
2013,區域醫院,Escherichia coli,Ciprofloxacin,129199,95261,59788,35473,69
2013,區域醫院,Escherichia coli,Ceftazidime,129199,82151,61078,21073,68
2013,區域醫院,Escherichia coli,Cefazolin,129199,82629,45584,37045,67
2013,區域醫院,Escherichia coli,Ceftriaxone,129199,78618,56582,22036,69
2013,區域醫院,Escherichia coli,Ertapenem,129199,87744,84961,2783,69
2013,區域醫院,Escherichia coli,Gentamicin,129199,117807,86447,31360,70
2013,區域醫院,Escherichia coli,Imipenem,129199,74771,71871,2900,70
2013,區域醫院,Escherichia coli,Levofloxacin,129199,76157,50357,25800,68
2013,區域醫院,Escherichia coli,Meropenem,129199,52218,49058,3160,68
2013,區域醫院,Klebsiella pneumoniae,Ampicillin(SAM),64981,33306,19210,14096,71
2013,區域醫院,Klebsiella pneumoniae,Amikacin,64981,52933,46145,6788,73
2013,區域醫院,Klebsiella pneumoniae,Cefuroxime,64981,17403,9458,7945,66
2013,區域醫院,Klebsiella pneumoniae,Cefotaxime,64981,32601,21281,11320,71
2013,區域醫院,Klebsiella pneumoniae,Ciprofloxacin,64981,46535,30881,15654,73
2013,區域醫院,Klebsiella pneumoniae,Ceftazidime,64981,41743,28669,13074,72
2013,區域醫院,Klebsiella pneumoniae,Cefazolin,64981,40033,22916,17117,70
2013,區域醫院,Klebsiella pneumoniae,Ceftriaxone,64981,23321,17914,5407,70
2013,區域醫院,Klebsiella pneumoniae,Ertapenem,64981,40213,36192,4021,79
2013,區域醫院,Klebsiella pneumoniae,Gentamicin,64981,55768,41075,14693,74
2013,區域醫院,Klebsiella pneumoniae,Imipenem,64981,42945,39900,3045,79
2013,區域醫院,Klebsiella pneumoniae,Levofloxacin,64981,22631,15798,6833,69
2013,區域醫院,Klebsiella pneumoniae,Meropenem,64981,25564,23307,2257,77
2013,區域醫院,Proteus mirabilis,Ampicillin(SAM),19654,15375,9822,5553,70
2013,區域醫院,Proteus mirabilis,Ampicillin,19654,13063,4157,8906,69
2013,區域醫院,Proteus mirabilis,Amikacin,19654,12385,11082,1303,66
2013,區域醫院,Proteus mirabilis,Cefuroxime,19654,6473,4691,1782,63
2013,區域醫院,Proteus mirabilis,Cefotaxime,19654,8897,6893,2004,64
2013,區域醫院,Proteus mirabilis,Ciprofloxacin,19654,11807,7739,4068,66
2013,區域醫院,Proteus mirabilis,Cefazolin,19654,18657,8855,9802,69
2013,區域醫院,Proteus mirabilis,Ceftriaxone,19654,8369,7035,1334,67
2013,區域醫院,Proteus mirabilis,Gentamicin,19654,18280,10376,7904,70
2013,區域醫院,Proteus mirabilis,Levofloxacin,19654,7833,5519,2314,66
2013,區域醫院,Pseudomonas aeruginosa,Amikacin,53000,33158,30819,2339,67
2013,區域醫院,Pseudomonas aeruginosa,Cefepime,53000,35416,30456,4960,68
2013,區域醫院,Pseudomonas aeruginosa,Ciprofloxacin,53000,43976,31352,12624,70
2013,區域醫院,Pseudomonas aeruginosa,Ceftazidime,53000,49895,43356,6539,70
2013,區域醫院,Pseudomonas aeruginosa,Gentamicin,53000,47595,37881,9714,70
2013,區域醫院,Pseudomonas aeruginosa,Imipenem,53000,43512,37224,6288,70
2013,區域醫院,Pseudomonas aeruginosa,Levofloxacin,53000,35129,24166,10963,68
2013,區域醫院,Pseudomonas aeruginosa,Meropenem,53000,35488,30415,5073,69
2013,區域醫院,Pseudomonas aeruginosa,Piperacillin/Tazobactam,53000,51163,42585,8578,70
2013,區域醫院,Pseudomonas aeruginosa,Piperacillin,53000,22796,17295,5501,67
2013,區域醫院,Enterococcus faecalis,Ampicillin,14700,10206,9872,334,67
2013,區域醫院,Enterococcus faecalis,Gentamicin-High,14700,10250,5221,5029,68
2013,區域醫院,Enterococcus faecalis,Vancomycin,14700,14620,14466,154,77
2013,區域醫院,Enterococcus faecium,Ampicillin,5899,4284,507,3777,67
2013,區域醫院,Enterococcus faecium,Gentamicin-High,5899,4223,1568,2655,68
2013,區域醫院,Enterococcus faecium,Vancomycin,5899,5904,3961,1943,77
2013,區域醫院,Staphylococcus aureus,Ciprofloxacin,59538,18841,11853,6988,71
2013,區域醫院,Staphylococcus aureus,Oxacillin,59538,59029,27206,31823,83
2013,區域醫院,Staphylococcus aureus,Trimethoprim/Sulfamethoxazole,59538,49209,39912,9297,74
2013,區域醫院,Staphylococcus aureus,Vancomycin,59538,47623,47044,579,75
2012,醫學中心,Acinetobacter baumannii,Ampicillin(SAM),32208,23382,9457,13925,14
2012,醫學中心,Acinetobacter baumannii,Amikacin,32208,18894,8063,10831,13
2012,醫學中心,Acinetobacter baumannii,Cefepime,32208,23427,7589,15838,14
2012,醫學中心,Acinetobacter baumannii,Ciprofloxacin,32208,23602,6901,16701,14
2012,醫學中心,Acinetobacter baumannii,Ceftazidime,32208,23438,8200,15238,14
2012,醫學中心,Acinetobacter baumannii,Gentamicin,32208,18755,5266,13489,13
2012,醫學中心,Acinetobacter baumannii,Imipenem,32208,30347,10370,19977,21
2012,醫學中心,Acinetobacter baumannii,Levofloxacin,32208,13632,4910,8722,13
2012,醫學中心,Acinetobacter baumannii,Meropenem,32208,16501,5015,11486,16
2012,醫學中心,Acinetobacter baumannii,Piperacillin/Tazobactam,32208,23585,6833,16752,14
2012,醫學中心,Enterobacter cloacae,Cefotaxime,8299,3809,2508,1301,13
2012,醫學中心,Enterobacter cloacae,Ceftazidime,8299,4998,2876,2122,12
2012,醫學中心,Enterobacter cloacae,Ceftriaxone,8299,4571,2512,2059,11
2012,醫學中心,Enterobacter cloacae,Ertapenem,8299,7124,6293,831,13
2012,醫學中心,Enterobacter cloacae,Imipenem,8299,3147,3064,83,12
2012,醫學中心,Enterobacter cloacae,Meropenem,8299,1694,1672,22,12
2012,醫學中心,Escherichia coli,Amikacin,70838,62969,62112,857,13
2012,醫學中心,Escherichia coli,Cefotaxime,70838,29571,21848,7723,13
2012,醫學中心,Escherichia coli,Ciprofloxacin,70838,56961,36885,20076,13
2012,醫學中心,Escherichia coli,Ceftazidime,70838,30451,22709,7742,12
2012,醫學中心,Escherichia coli,Ceftriaxone,70838,41971,30825,11146,11
2012,醫學中心,Escherichia coli,Ertapenem,70838,57618,57121,497,13
2012,醫學中心,Escherichia coli,Gentamicin,70838,69751,51584,18167,13
2012,醫學中心,Escherichia coli,Imipenem,70838,26162,26083,79,12
2012,醫學中心,Escherichia coli,Levofloxacin,70838,54949,36832,18117,12
2012,醫學中心,Escherichia coli,Meropenem,70838,14017,13974,43,12
2012,醫學中心,Klebsiella pneumoniae,Amikacin,46683,29138,27380,1758,14
2012,醫學中心,Klebsiella pneumoniae,Cefotaxime,46683,18954,13881,5073,14
2012,醫學中心,Klebsiella pneumoniae,Ciprofloxacin,46683,27341,19491,7850,14
2012,醫學中心,Klebsiella pneumoniae,Ceftazidime,46683,21305,15178,6127,14
2012,醫學中心,Klebsiella pneumoniae,Ertapenem,46683,42009,38842,3167,20
2012,醫學中心,Klebsiella pneumoniae,Gentamicin,46683,33483,26833,6650,14
2012,醫學中心,Klebsiella pneumoniae,Imipenem,46683,22444,21553,891,21
2012,醫學中心,Klebsiella pneumoniae,Meropenem,46683,12074,11831,243,16
2012,醫學中心,Proteus mirabilis,Ampicillin(SAM),9620,5231,3934,1297,13
2012,醫學中心,Proteus mirabilis,Ampicillin,9620,8535,3484,5051,13
2012,醫學中心,Proteus mirabilis,Cefazolin,9620,9605,5321,4284,13
2012,醫學中心,Proteus mirabilis,Gentamicin,9620,9575,6492,3083,13
2012,醫學中心,Pseudomonas aeruginosa,Ciprofloxacin,33580,33537,26619,6918,13
2012,醫學中心,Pseudomonas aeruginosa,Ceftazidime,33580,32805,27547,5258,13
2012,醫學中心,Pseudomonas aeruginosa,Gentamicin,33580,29614,24983,4631,13
2012,醫學中心,Pseudomonas aeruginosa,Imipenem,33580,31989,26844,5145,13
2012,醫學中心,Pseudomonas aeruginosa,Levofloxacin,33580,20511,15827,4684,13
2012,醫學中心,Pseudomonas aeruginosa,Meropenem,33580,23621,20819,2802,13
2012,醫學中心,Pseudomonas aeruginosa,Piperacillin/Tazobactam,33580,33325,28437,4888,13
2012,醫學中心,Pseudomonas aeruginosa,Piperacillin,33580,14458,11701,2757,11
2012,醫學中心,Enterococcus faecalis,Ampicillin,11687,6933,6877,56,14
2012,醫學中心,Enterococcus faecalis,Gentamicin-High,11687,3326,1865,1461,14
2012,醫學中心,Enterococcus faecalis,Vancomycin,11687,12182,12096,86,21
2012,醫學中心,Enterococcus faecium,Ampicillin,7331,4515,397,4118,14
2012,醫學中心,Enterococcus faecium,Gentamicin-High,7331,2907,1128,1779,14
2012,醫學中心,Enterococcus faecium,Vancomycin,7331,7559,3952,3607,21
2012,醫學中心,Staphylococcus aureus,Ciprofloxacin,48110,11617,6977,4640,12
2012,醫學中心,Staphylococcus aureus,Oxacillin,48110,48694,22968,25726,21
2012,醫學中心,Staphylococcus aureus,Trimethoprim/Sulfamethoxazole,48110,36037,28105,7932,14
2012,醫學中心,Staphylococcus aureus,Vancomycin,48110,28232,28219,13,15
2012,區域醫院,Acinetobacter baumannii,Ampicillin(SAM),35263,28001,9852,18149,69
2012,區域醫院,Acinetobacter baumannii,Amikacin,35263,25201,8472,16729,70
2012,區域醫院,Acinetobacter baumannii,Cefepime,35263,25212,6142,19070,70
2012,區域醫院,Acinetobacter baumannii,Ciprofloxacin,35263,26491,5912,20579,70
2012,區域醫院,Acinetobacter baumannii,Ceftazidime,35263,29630,7381,22249,71
2012,區域醫院,Acinetobacter baumannii,Gentamicin,35263,27464,6757,20707,71
2012,區域醫院,Acinetobacter baumannii,Imipenem,35263,27460,9556,17904,81
2012,區域醫院,Acinetobacter baumannii,Levofloxacin,35263,19727,4651,15076,67
2012,區域醫院,Acinetobacter baumannii,Meropenem,35263,17713,6125,11588,74
2012,區域醫院,Acinetobacter baumannii,Piperacillin/Tazobactam,35263,28018,5994,22024,71
2012,區域醫院,Enterobacter cloacae,Cefotaxime,9372,5007,3349,1658,61
2012,區域醫院,Enterobacter cloacae,Ceftazidime,9372,6278,4507,1771,62
2012,區域醫院,Enterobacter cloacae,Ceftriaxone,9372,5201,3719,1482,63
2012,區域醫院,Enterobacter cloacae,Ertapenem,9372,4499,4202,297,66
2012,區域醫院,Enterobacter cloacae,Imipenem,9372,5423,5243,180,62
2012,區域醫院,Enterobacter cloacae,Meropenem,9372,3464,3443,21,60
2012,區域醫院,Escherichia coli,Amikacin,119324,99951,96976,2975,63
2012,區域醫院,Escherichia coli,Cefotaxime,119324,57474,41622,15852,60
2012,區域醫院,Escherichia coli,Ciprofloxacin,119324,91058,58891,32167,63
2012,區域醫院,Escherichia coli,Ceftazidime,119324,74527,55897,18630,61
2012,區域醫院,Escherichia coli,Ceftriaxone,119324,65352,47158,18194,62
2012,區域醫院,Escherichia coli,Ertapenem,119324,57878,56908,970,64
2012,區域醫院,Escherichia coli,Gentamicin,119324,108161,77550,30611,65
2012,區域醫院,Escherichia coli,Imipenem,119324,50732,50463,269,63
2012,區域醫院,Escherichia coli,Levofloxacin,119324,62881,41739,21142,61
2012,區域醫院,Escherichia coli,Meropenem,119324,34752,34606,146,61
2012,區域醫院,Klebsiella pneumoniae,Amikacin,65426,51034,44126,6908,69
2012,區域醫院,Klebsiella pneumoniae,Cefotaxime,65426,30170,20606,9564,66
2012,區域醫院,Klebsiella pneumoniae,Ciprofloxacin,65426,48862,33852,15010,70
2012,區域醫院,Klebsiella pneumoniae,Ceftazidime,65426,40444,28238,12206,67
2012,區域醫院,Klebsiella pneumoniae,Ertapenem,65426,32909,30225,2684,75
2012,區域醫院,Klebsiella pneumoniae,Gentamicin,65426,54185,39242,14943,71
2012,區域醫院,Klebsiella pneumoniae,Imipenem,65426,39353,38052,1301,76
2012,區域醫院,Klebsiella pneumoniae,Meropenem,65426,21707,20408,1299,73
2012,區域醫院,Proteus mirabilis,Ampicillin(SAM),18918,14065,9032,5033,62
2012,區域醫院,Proteus mirabilis,Ampicillin,18918,11990,3592,8398,60
2012,區域醫院,Proteus mirabilis,Cefazolin,18918,17158,7964,9194,63
2012,區域醫院,Proteus mirabilis,Gentamicin,18918,17315,9715,7600,64
2012,區域醫院,Pseudomonas aeruginosa,Ciprofloxacin,50795,45706,33719,11987,64
2012,區域醫院,Pseudomonas aeruginosa,Ceftazidime,50795,49863,42400,7463,65
2012,區域醫院,Pseudomonas aeruginosa,Gentamicin,50795,47973,37843,10130,65
2012,區域醫院,Pseudomonas aeruginosa,Imipenem,50795,44672,38363,6309,66
2012,區域醫院,Pseudomonas aeruginosa,Levofloxacin,50795,34030,23766,10264,61
2012,區域醫院,Pseudomonas aeruginosa,Meropenem,50795,31913,27846,4067,63
2012,區域醫院,Pseudomonas aeruginosa,Piperacillin/Tazobactam,50795,48801,41296,7505,65
2012,區域醫院,Pseudomonas aeruginosa,Piperacillin,50795,24685,20026,4659,61
2012,區域醫院,Enterococcus faecalis,Ampicillin,12891,9365,8962,403,64
2012,區域醫院,Enterococcus faecalis,Gentamicin-High,12891,8160,4280,3880,63
2012,區域醫院,Enterococcus faecalis,Vancomycin,12891,12884,12816,68,74
2012,區域醫院,Enterococcus faecium,Ampicillin,5322,4090,551,3539,64
2012,區域醫院,Enterococcus faecium,Gentamicin-High,5322,3580,1303,2277,63
2012,區域醫院,Enterococcus faecium,Vancomycin,5322,5296,3453,1843,74
2012,區域醫院,Staphylococcus aureus,Ciprofloxacin,59372,17976,11635,6341,65
2012,區域醫院,Staphylococcus aureus,Oxacillin,59372,58891,27993,30898,82
2012,區域醫院,Staphylococcus aureus,Trimethoprim/Sulfamethoxazole,59372,47255,38253,9002,70
2012,區域醫院,Staphylococcus aureus,Vancomycin,59372,47147,47127,20,75
2011,醫學中心,Acinetobacter baumannii,Ampicillin(SAM),34633,25141,11165,13976,14
2011,醫學中心,Acinetobacter baumannii,Amikacin,34633,18297,7786,10511,12
2011,醫學中心,Acinetobacter baumannii,Cefepime,34633,24419,8388,16031,14
2011,醫學中心,Acinetobacter baumannii,Ciprofloxacin,34633,25444,7834,17610,14
2011,醫學中心,Acinetobacter baumannii,Ceftazidime,34633,25333,8782,16551,14
2011,醫學中心,Acinetobacter baumannii,Gentamicin,34633,23494,7083,16411,14
2011,醫學中心,Acinetobacter baumannii,Imipenem,34633,30840,11788,19052,21
2011,醫學中心,Acinetobacter baumannii,Levofloxacin,34633,16307,5833,10474,12
2011,醫學中心,Acinetobacter baumannii,Piperacillin/Tazobactam,34633,23339,6874,16465,14
2011,醫學中心,Enterobacter cloacae,Cefotaxime,8248,3071,1796,1275,10
2011,醫學中心,Enterobacter cloacae,Ceftazidime,8248,5235,2933,2302,10
2011,醫學中心,Enterobacter cloacae,Ceftriaxone,8248,5094,2850,2244,11
2011,醫學中心,Enterobacter cloacae,Imipenem,8248,2960,2837,123,12
2011,醫學中心,Enterobacter cloacae,Meropenem,8248,1285,1187,98,9
2011,醫學中心,Escherichia coli,Amikacin,68156,60795,58758,2037,13
2011,醫學中心,Escherichia coli,Cefotaxime,68156,20321,14832,5489,10
2011,醫學中心,Escherichia coli,Ciprofloxacin,68156,54157,35961,18196,13
2011,醫學中心,Escherichia coli,Ceftazidime,68156,31348,21712,9636,10
2011,醫學中心,Escherichia coli,Ceftriaxone,68156,45252,33196,12056,11
2011,醫學中心,Escherichia coli,Gentamicin,68156,67438,49567,17871,13
2011,醫學中心,Escherichia coli,Levofloxacin,68156,50612,33524,17088,10
2011,醫學中心,Klebsiella pneumoniae,Amikacin,48799,27697,25527,2170,13
2011,醫學中心,Klebsiella pneumoniae,Cefotaxime,48799,15993,11740,4253,11
2011,醫學中心,Klebsiella pneumoniae,Ciprofloxacin,48799,29666,21730,7936,14
2011,醫學中心,Klebsiella pneumoniae,Ceftazidime,48799,23053,16508,6545,11
2011,醫學中心,Klebsiella pneumoniae,Ertapenem,48799,40790,37795,2995,21
2011,醫學中心,Klebsiella pneumoniae,Gentamicin,48799,35736,28909,6827,14
2011,醫學中心,Klebsiella pneumoniae,Imipenem,48799,21516,20724,792,21
2011,醫學中心,Proteus mirabilis,Ampicillin(SAM),10030,4985,3548,1437,12
2011,醫學中心,Proteus mirabilis,Ampicillin,10030,8218,3450,4768,13
2011,醫學中心,Proteus mirabilis,Cefazolin,10030,8967,5102,3865,13
2011,醫學中心,Proteus mirabilis,Gentamicin,10030,9375,6216,3159,13
2011,醫學中心,Pseudomonas aeruginosa,Ciprofloxacin,35889,34972,27699,7273,13
2011,醫學中心,Pseudomonas aeruginosa,Ceftazidime,35889,35803,29765,6038,13
2011,醫學中心,Pseudomonas aeruginosa,Gentamicin,35889,28711,24195,4516,13
2011,醫學中心,Pseudomonas aeruginosa,Imipenem,35889,34864,29088,5776,13
2011,醫學中心,Pseudomonas aeruginosa,Levofloxacin,35889,22629,17508,5121,12
2011,醫學中心,Pseudomonas aeruginosa,Meropenem,35889,23195,19731,3464,11
2011,醫學中心,Pseudomonas aeruginosa,Piperacillin/Tazobactam,35889,35577,29770,5807,13
2011,醫學中心,Pseudomonas aeruginosa,Piperacillin,35889,13652,11133,2519,8
2011,醫學中心,Enterococcus faecalis,Ampicillin,11770,6848,6725,123,13
2011,醫學中心,Enterococcus faecalis,Gentamicin-High,11770,3498,2065,1433,14
2011,醫學中心,Enterococcus faecalis,Vancomycin,11770,11766,11631,135,21
2011,醫學中心,Enterococcus faecium,Ampicillin,7353,4729,443,4286,13
2011,醫學中心,Enterococcus faecium,Gentamicin-High,7353,3010,1124,1886,14
2011,醫學中心,Enterococcus faecium,Vancomycin,7353,7347,4125,3222,21
2011,醫學中心,Staphylococcus aureus,Ciprofloxacin,52339,12396,7565,4831,11
2011,醫學中心,Staphylococcus aureus,Oxacillin,52339,52181,24203,27978,21
2011,醫學中心,Staphylococcus aureus,Trimethoprim/Sulfamethoxazole,52339,37596,29205,8391,14
2011,醫學中心,Staphylococcus aureus,Vancomycin,52339,31969,31955,14,15
2011,區域醫院,Acinetobacter baumannii,Ampicillin(SAM),34927,26707,9085,17622,64
2011,區域醫院,Acinetobacter baumannii,Amikacin,34927,25208,8526,16682,64
2011,區域醫院,Acinetobacter baumannii,Cefepime,34927,24967,5885,19082,66
2011,區域醫院,Acinetobacter baumannii,Ciprofloxacin,34927,25962,5537,20425,67
2011,區域醫院,Acinetobacter baumannii,Ceftazidime,34927,28856,6699,22157,67
2011,區域醫院,Acinetobacter baumannii,Gentamicin,34927,27295,6407,20888,65
2011,區域醫院,Acinetobacter baumannii,Imipenem,34927,31497,11684,19813,82
2011,區域醫院,Acinetobacter baumannii,Levofloxacin,34927,18781,4120,14661,61
2011,區域醫院,Acinetobacter baumannii,Piperacillin/Tazobactam,34927,27364,5828,21536,67
2011,區域醫院,Enterobacter cloacae,Cefotaxime,8364,4283,2771,1512,54
2011,區域醫院,Enterobacter cloacae,Ceftazidime,8364,5412,3886,1526,55
2011,區域醫院,Enterobacter cloacae,Ceftriaxone,8364,5033,3526,1507,58
2011,區域醫院,Enterobacter cloacae,Imipenem,8364,4902,4657,245,58
2011,區域醫院,Enterobacter cloacae,Meropenem,8364,2855,2652,203,52
2011,區域醫院,Escherichia coli,Amikacin,100586,87255,84139,3116,58
2011,區域醫院,Escherichia coli,Cefotaxime,100586,48982,34823,14159,56
2011,區域醫院,Escherichia coli,Ciprofloxacin,100586,79153,51311,27842,60
2011,區域醫院,Escherichia coli,Ceftazidime,100586,59630,46632,12998,57
2011,區域醫院,Escherichia coli,Ceftriaxone,100586,59789,42831,16958,60
2011,區域醫院,Escherichia coli,Gentamicin,100586,94725,67114,27611,59
2011,區域醫院,Escherichia coli,Levofloxacin,100586,54821,35897,18924,56
2011,區域醫院,Klebsiella pneumoniae,Amikacin,60574,47842,40714,7128,64
2011,區域醫院,Klebsiella pneumoniae,Cefotaxime,60574,28219,19465,8754,61
2011,區域醫院,Klebsiella pneumoniae,Ciprofloxacin,60574,46164,31603,14561,66
2011,區域醫院,Klebsiella pneumoniae,Ceftazidime,60574,34664,25129,9535,64
2011,區域醫院,Klebsiella pneumoniae,Ertapenem,60574,28195,25380,2815,74
2011,區域醫院,Klebsiella pneumoniae,Gentamicin,60574,52039,37698,14341,65
2011,區域醫院,Klebsiella pneumoniae,Imipenem,60574,39223,37336,1887,76
2011,區域醫院,Proteus mirabilis,Ampicillin(SAM),18333,12955,7900,5055,58
2011,區域醫院,Proteus mirabilis,Ampicillin,18333,12743,3981,8762,57
2011,區域醫院,Proteus mirabilis,Cefazolin,18333,16395,7666,8729,58
2011,區域醫院,Proteus mirabilis,Gentamicin,18333,17072,8967,8105,57
2011,區域醫院,Pseudomonas aeruginosa,Ciprofloxacin,49688,44429,32284,12145,61
2011,區域醫院,Pseudomonas aeruginosa,Ceftazidime,49688,48151,42126,6025,61
2011,區域醫院,Pseudomonas aeruginosa,Gentamicin,49688,46914,36402,10512,59
2011,區域醫院,Pseudomonas aeruginosa,Imipenem,49688,43814,38106,5708,61
2011,區域醫院,Pseudomonas aeruginosa,Levofloxacin,49688,33141,22929,10212,56
2011,區域醫院,Pseudomonas aeruginosa,Meropenem,49688,28709,24908,3801,55
2011,區域醫院,Pseudomonas aeruginosa,Piperacillin/Tazobactam,49688,44448,38160,6288,61
2011,區域醫院,Pseudomonas aeruginosa,Piperacillin,49688,24592,20110,4482,57
2011,區域醫院,Enterococcus faecalis,Ampicillin,11435,8008,7437,571,57
2011,區域醫院,Enterococcus faecalis,Gentamicin-High,11435,6003,3110,2893,55
2011,區域醫院,Enterococcus faecalis,Vancomycin,11435,11356,11266,90,70
2011,區域醫院,Enterococcus faecium,Ampicillin,4565,3309,479,2830,57
2011,區域醫院,Enterococcus faecium,Gentamicin-High,4565,2584,847,1737,55
2011,區域醫院,Enterococcus faecium,Vancomycin,4565,4550,3056,1494,70
2011,區域醫院,Staphylococcus aureus,Ciprofloxacin,58159,15819,10341,5478,61
2011,區域醫院,Staphylococcus aureus,Oxacillin,58159,57976,27378,30598,82
2011,區域醫院,Staphylococcus aureus,Trimethoprim/Sulfamethoxazole,58159,43405,33949,9456,65
2011,區域醫院,Staphylococcus aureus,Vancomycin,58159,43718,43476,242,69
2010,醫學中心,Acinetobacter baumannii,Ampicillin(SAM),35759,26216,12287,13929,13
2010,醫學中心,Acinetobacter baumannii,Amikacin,35759,18388,7572,10816,11
2010,醫學中心,Acinetobacter baumannii,Cefepime,35759,25025,8864,16161,13
2010,醫學中心,Acinetobacter baumannii,Ciprofloxacin,35759,26487,8176,18311,14
2010,醫學中心,Acinetobacter baumannii,Ceftazidime,35759,26547,8753,17794,14
2010,醫學中心,Acinetobacter baumannii,Gentamicin,35759,25643,7707,17936,14
2010,醫學中心,Acinetobacter baumannii,Imipenem,35759,32451,13283,19168,21
2010,醫學中心,Acinetobacter baumannii,Levofloxacin,35759,16126,5859,10267,10
2010,醫學中心,Acinetobacter baumannii,Piperacillin/Tazobactam,35759,24098,6741,17357,14
2010,醫學中心,Enterobacter cloacae,Cefotaxime,8602,3255,2017,1238,8
2010,醫學中心,Enterobacter cloacae,Ceftazidime,8602,5476,2896,2580,11
2010,醫學中心,Enterobacter cloacae,Ceftriaxone,8602,5377,2950,2427,11
2010,醫學中心,Enterobacter cloacae,Imipenem,8602,2276,2037,239,11
2010,醫學中心,Enterobacter cloacae,Meropenem,8602,1193,1140,53,7
2010,醫學中心,Escherichia coli,Amikacin,64860,60710,58337,2373,12
2010,醫學中心,Escherichia coli,Cefotaxime,64860,20471,14515,5956,8
2010,醫學中心,Escherichia coli,Ciprofloxacin,64860,52764,35023,17741,12
2010,醫學中心,Escherichia coli,Ceftazidime,64860,30393,19291,11102,11
2010,醫學中心,Escherichia coli,Ceftriaxone,64860,43830,31226,12604,11
2010,醫學中心,Escherichia coli,Gentamicin,64860,64291,46467,17824,13
2010,醫學中心,Escherichia coli,Levofloxacin,64860,45134,28887,16247,11
2010,醫學中心,Klebsiella pneumoniae,Amikacin,47434,28435,25461,2974,12
2010,醫學中心,Klebsiella pneumoniae,Cefotaxime,47434,16492,11847,4645,9
2010,醫學中心,Klebsiella pneumoniae,Ciprofloxacin,47434,31326,23034,8292,13
2010,醫學中心,Klebsiella pneumoniae,Ceftazidime,47434,23824,16202,7622,12
2010,醫學中心,Klebsiella pneumoniae,Ertapenem,47434,37667,35999,1668,19
2010,醫學中心,Klebsiella pneumoniae,Gentamicin,47434,35690,27974,7716,14
2010,醫學中心,Klebsiella pneumoniae,Imipenem,47434,20006,18202,1804,18
2010,醫學中心,Proteus mirabilis,Ampicillin(SAM),10063,4385,2961,1424,10
2010,醫學中心,Proteus mirabilis,Ampicillin,10063,8033,3211,4822,12
2010,醫學中心,Proteus mirabilis,Cefazolin,10063,8471,6001,2470,11
2010,醫學中心,Proteus mirabilis,Gentamicin,10063,9773,6204,3569,13
2010,醫學中心,Pseudomonas aeruginosa,Ciprofloxacin,35409,35203,27955,7248,13
2010,醫學中心,Pseudomonas aeruginosa,Ceftazidime,35409,35234,30163,5071,13
2010,醫學中心,Pseudomonas aeruginosa,Gentamicin,35409,30113,24998,5115,13
2010,醫學中心,Pseudomonas aeruginosa,Imipenem,35409,35020,30074,4946,13
2010,醫學中心,Pseudomonas aeruginosa,Levofloxacin,35409,21097,16335,4762,10
2010,醫學中心,Pseudomonas aeruginosa,Meropenem,35409,20148,17629,2519,10
2010,醫學中心,Pseudomonas aeruginosa,Piperacillin/Tazobactam,35409,34333,29330,5003,13
2010,醫學中心,Pseudomonas aeruginosa,Piperacillin,35409,16258,13396,2862,7
2010,醫學中心,Enterococcus faecalis,Ampicillin,9418,5884,5770,114,13
2010,醫學中心,Enterococcus faecalis,Gentamicin-High,9418,2355,1357,998,10
2010,醫學中心,Enterococcus faecalis,Vancomycin,9418,9410,9336,74,19
2010,醫學中心,Enterococcus faecium,Ampicillin,5780,3967,399,3568,13
2010,醫學中心,Enterococcus faecium,Gentamicin-High,5780,2118,744,1374,10
2010,醫學中心,Enterococcus faecium,Vancomycin,5780,5775,3205,2570,19
2010,醫學中心,Staphylococcus aureus,Ciprofloxacin,50890,10142,5253,4889,7
2010,醫學中心,Staphylococcus aureus,Oxacillin,50890,50606,22717,27889,21
2010,醫學中心,Staphylococcus aureus,Trimethoprim/Sulfamethoxazole,50890,37079,27504,9575,13
2010,醫學中心,Staphylococcus aureus,Vancomycin,50890,36484,36464,20,16
2010,區域醫院,Acinetobacter baumannii,Ampicillin(SAM),33674,23888,9127,14761,60
2010,區域醫院,Acinetobacter baumannii,Amikacin,33674,24439,7523,16916,64
2010,區域醫院,Acinetobacter baumannii,Cefepime,33674,21136,5077,16059,61
2010,區域醫院,Acinetobacter baumannii,Ciprofloxacin,33674,21882,4396,17486,63
2010,區域醫院,Acinetobacter baumannii,Ceftazidime,33674,26192,6135,20057,65
2010,區域醫院,Acinetobacter baumannii,Gentamicin,33674,25039,5724,19315,64
2010,區域醫院,Acinetobacter baumannii,Imipenem,33674,30880,12650,18230,80
2010,區域醫院,Acinetobacter baumannii,Levofloxacin,33674,17673,3854,13819,59
2010,區域醫院,Acinetobacter baumannii,Piperacillin/Tazobactam,33674,25219,5729,19490,63
2010,區域醫院,Enterobacter cloacae,Cefotaxime,7418,3916,2451,1465,42
2010,區域醫院,Enterobacter cloacae,Ceftazidime,7418,4502,3101,1401,50
2010,區域醫院,Enterobacter cloacae,Ceftriaxone,7418,4108,2774,1334,49
2010,區域醫院,Enterobacter cloacae,Imipenem,7418,4387,4272,115,47
2010,區域醫院,Enterobacter cloacae,Meropenem,7418,2408,2287,121,39
2010,區域醫院,Escherichia coli,Amikacin,83290,74964,71921,3043,53
2010,區域醫院,Escherichia coli,Cefotaxime,83290,41018,29949,11069,44
2010,區域醫院,Escherichia coli,Ciprofloxacin,83290,62321,40544,21777,51
2010,區域醫院,Escherichia coli,Ceftazidime,83290,45973,35455,10518,51
2010,區域醫院,Escherichia coli,Ceftriaxone,83290,45840,33936,11904,50
2010,區域醫院,Escherichia coli,Gentamicin,83290,79073,55671,23402,56
2010,區域醫院,Escherichia coli,Levofloxacin,83290,45009,30246,14763,52
2010,區域醫院,Klebsiella pneumoniae,Amikacin,51708,41137,35489,5648,60
2010,區域醫院,Klebsiella pneumoniae,Cefotaxime,51708,23743,16850,6893,48
2010,區域醫院,Klebsiella pneumoniae,Ciprofloxacin,51708,36673,25639,11034,58
2010,區域醫院,Klebsiella pneumoniae,Ceftazidime,51708,27381,19720,7661,58
2010,區域醫院,Klebsiella pneumoniae,Ertapenem,51708,23555,22755,800,65
2010,區域醫院,Klebsiella pneumoniae,Gentamicin,51708,42789,31364,11425,63
2010,區域醫院,Klebsiella pneumoniae,Imipenem,51708,33744,32489,1255,71
2010,區域醫院,Proteus mirabilis,Ampicillin(SAM),15107,10325,6572,3753,53
2010,區域醫院,Proteus mirabilis,Ampicillin,15107,10932,3429,7503,52
2010,區域醫院,Proteus mirabilis,Cefazolin,15107,13416,7725,5691,55
2010,區域醫院,Proteus mirabilis,Gentamicin,15107,14185,7466,6719,56
2010,區域醫院,Pseudomonas aeruginosa,Ciprofloxacin,44010,36492,26991,9501,53
2010,區域醫院,Pseudomonas aeruginosa,Ceftazidime,44010,42818,37521,5297,56
2010,區域醫院,Pseudomonas aeruginosa,Gentamicin,44010,41845,32150,9695,54
2010,區域醫院,Pseudomonas aeruginosa,Imipenem,44010,38750,33589,5161,53
2010,區域醫院,Pseudomonas aeruginosa,Levofloxacin,44010,31045,21937,9108,52
2010,區域醫院,Pseudomonas aeruginosa,Meropenem,44010,26336,22349,3987,44
2010,區域醫院,Pseudomonas aeruginosa,Piperacillin/Tazobactam,44010,39589,33811,5778,53
2010,區域醫院,Pseudomonas aeruginosa,Piperacillin,44010,24137,20017,4120,45
2010,區域醫院,Enterococcus faecalis,Ampicillin,8304,6042,5870,172,55
2010,區域醫院,Enterococcus faecalis,Gentamicin-High,8304,4128,2230,1898,50
2010,區域醫院,Enterococcus faecalis,Vancomycin,8304,8328,8248,80,66
2010,區域醫院,Enterococcus faecium,Ampicillin,3240,2354,395,1959,54
2010,區域醫院,Enterococcus faecium,Gentamicin-High,3240,1695,636,1059,50
2010,區域醫院,Enterococcus faecium,Vancomycin,3240,3237,2238,999,65
2010,區域醫院,Staphylococcus aureus,Ciprofloxacin,50213,13150,8119,5031,51
2010,區域醫院,Staphylococcus aureus,Oxacillin,50213,50517,23445,27072,81
2010,區域醫院,Staphylococcus aureus,Trimethoprim/Sulfamethoxazole,50213,35242,26962,8280,61
2010,區域醫院,Staphylococcus aureus,Vancomycin,50213,37362,37355,7,70
