微生物名稱,政府機關數,醫事機構數,學術機構數,研究機構數,其他機構數,合計數
Botulinum neurotoxins,4,0,0,0,10,14
Cholera toxin,0,5,8,10,1,24
Clostridium perfringens toxins,1,1,0,0,0,2
Corynebacterium diphtheriae toxin,1,1,7,6,0,15
HT-2 toxin,1,0,0,0,6,7
Pertussis toxin,1,0,7,9,0,17
Staphylococcal enterotoxins(subtypes A、B、C、D及E),0,2,0,4,2,8
Staphylococcus aureus toxins,0,0,0,1,0,1
T-2 toxin,1,0,0,0,7,8
Tetanus toxin,2,0,1,0,0,3
