病原體名稱,政府機關數,醫事機構數,學術機構數,研究機構數,其他機構數,合計數
Acanthamoeba spp.,1,0,0,0,0,1
Acidovorax spp.,0,3,1,0,0,4
Acinetobacter baumannii,5,138,64,25,32,264
Acinetobacter baumannii/calcoaceticus complex,0,16,2,2,3,23
Acinetobacter johnsonii,2,19,2,5,1,29
Acinetobacter lwoffii,1,55,4,4,2,66
Acinetobacter lwoffii/haemolyticus,1,20,1,2,0,24
Acremonium falciforme,0,0,0,2,0,2
Acremonium kiliense,0,2,0,0,0,2
Actinobacillus spp.,3,9,1,1,17,31
Actinomyces pyogenes,1,4,0,1,0,6
Adenovirus,4,39,58,12,42,155
Aerococcus urinae,0,8,0,2,1,11
Aerococcus viridans,1,28,1,6,1,37
Aeromonas caviae,2,32,0,5,1,40
Aeromonas hydrophila,6,75,20,10,6,117
Aeromonas salmonicida,0,4,1,4,4,13
Aeromonas sobria,2,39,0,4,0,45
Aeromonas veronii,1,29,0,6,1,37
Aggregatibacter actinomycetemcomitans,0,13,10,2,5,30
Aggregatibacter aphrophilus,0,20,0,2,1,23
Aggregatibacter segnis,0,2,0,0,0,2
Akabanevirus,1,0,0,0,0,1
Alcaligenes faecalis,0,35,4,6,1,46
Anaerococcus vaginalis,0,2,0,1,0,3
Arcanobacterium haemolyticum,1,7,0,2,2,12
Arizona hinshawii,0,2,0,0,0,2
Ascaris lumbricoides,0,1,0,0,0,1
Aspergillus flavus,3,18,15,5,4,45
Aspergillus fumigatus,2,24,2,5,6,39
Aspergillus hongkongensis,0,0,1,1,0,2
Babesia microti,0,1,0,0,0,1
Bacillus cereus,29,36,30,13,48,156
Bacteroides capillosus,0,13,0,0,0,13
Bacteroides eggerthii,0,8,2,0,0,10
Bacteroides fragilis,0,103,6,7,19,135
Bacteroides ovatus,0,66,4,2,0,72
Bacteroides thetaiotaomicron,0,58,4,6,1,69
Bacteroides ureolyticus,0,12,0,2,0,14
Bacteroides vulgatus,1,45,4,3,2,55
Bartonella bovis,0,0,1,0,0,1
Bartonella henselae,0,0,2,0,0,2
Bartonella quintana,0,0,1,0,0,1
Bartonella spp.,1,0,0,0,0,1
Bartonella vinsonii,0,0,1,0,0,1
Bergeyella zoohelcum,0,3,0,0,0,3
Blastomyces dermatitidis,0,1,0,0,0,1
Bocavirus,0,0,0,0,1,1
Bordetella  pertussis,6,3,3,4,10,26
Bordetella bronchiseptica,5,16,2,7,26,56
Bordetella holmesii,1,0,0,0,0,1
Bordetella parapertussis,2,3,0,0,0,5
Bordetella spp.,3,5,1,6,2,17
Borrelia burgdorferi,0,0,0,2,2,4
Borrelia spp.,1,0,0,0,0,1
Brevundimonas diminuta,0,27,1,4,26,58
Burkholderia cenocepacia,0,1,0,0,1,2
Burkholderia cepacia,2,53,4,5,18,82
Burkholderia gladioli,0,8,3,4,1,16
Burkholderia spp.,2,24,2,4,29,61
Burkholderia vietnamiensis,0,1,0,0,0,1
Calicivirus,2,0,1,1,0,4
Campylobacter coli,4,25,1,3,1,34
Campylobacter concisus ,0,2,1,2,0,5
Campylobacter fetus,1,19,0,2,0,22
Campylobacter jejuni  ,5,49,7,7,6,74
Campylobacter spp.,2,30,3,5,2,42
Candida albicans,13,178,66,44,342,643
Candida glabrata,2,73,8,3,4,90
Candida intermedia,1,7,0,1,0,9
Candida krusei,2,56,7,2,3,70
Candida lusitaniae,2,24,1,4,1,32
Candida parapsilosis,2,77,9,5,3,96
Candida sake,1,8,0,1,0,10
Candida tropicalis,3,74,14,3,5,99
Cedecea davisae,0,4,0,4,0,8
Cedecea lapagei,0,2,0,4,1,7
Cedecea neteri,1,3,0,0,0,4
Cellulomonas hominis,0,1,0,0,0,1
Chikungunya attenuated vaccine strain,0,0,2,0,1,3
Chlamydia pneumoniae,1,0,1,1,1,4
Chlamydia psittaci,1,0,0,0,0,1
Chlamydia trachomatis,1,1,0,3,4,9
Chromobacterium violaceum,0,11,4,4,0,19
Chryseobacterium gleum,1,14,0,5,0,20
Chryseobacterium indologenes,0,46,1,5,1,53
Citrobacter amalonaticus,2,16,2,5,6,31
Citrobacter braakii,3,26,1,2,0,32
Citrobacter diversus,2,11,0,0,0,13
Citrobacter farmeri,2,9,0,2,0,13
Citrobacter freundii,5,70,9,6,11,101
Citrobacter koseri,2,64,5,5,3,79
Citrobacter spp.,3,17,3,8,1,32
Citrobacter werkmanii,0,12,0,2,0,14
Citrobacter youngae,2,18,1,2,0,23
Cladosporium bantianum,0,1,0,0,0,1
Clostridium baratii,0,2,0,0,0,2
Clostridium botulinum,3,0,0,2,2,7
Clostridium cadaveris,0,2,0,1,1,4
Clostridium chauvoei,0,0,0,1,0,1
Clostridium clostridioforme,0,9,0,3,0,12
Clostridium difficile,2,58,18,9,17,104
Clostridium haemolyticum,0,0,0,1,0,1
Clostridium histolyticum,0,1,0,1,0,2
Clostridium novyi,0,2,0,1,1,4
Clostridium perfringens,5,70,13,7,19,114
Clostridium ramosum,0,9,1,1,0,11
Clostridium septicum,0,80,1,1,4,86
Clostridium sporogenes,3,20,5,9,108,145
Clostridium tertium,0,11,0,1,0,12
Clostridium tetani,2,2,1,1,4,10
Coccidia spp.,0,0,3,0,0,3
Coronavirus,14,6,44,23,61,148
Corynebacterium amycolatum,2,10,0,0,0,12
Corynebacterium bovis,1,3,0,3,1,8
Corynebacterium diphtheriae,5,3,2,4,7,21
Corynebacterium jeikeium,0,24,2,2,1,29
Corynebacterium matruchotii,0,4,0,1,1,6
Corynebacterium propinquum,0,12,0,0,0,12
Corynebacterium pseudodiphtheriticum,0,10,0,0,1,11
Corynebacterium pseudotuberculosis,1,1,0,2,1,5
Corynebacterium renale,1,5,0,1,1,8
Corynebacterium spp.,2,28,4,5,4,43
Corynebacterium striatum,2,30,1,3,1,37
Corynebacterium urealyticum,0,9,0,2,2,13
Corynebacterium xerosis,0,4,0,1,3,8
Cowpox virus,0,0,0,1,0,1
Coxsackie virus,2,28,56,10,17,113
Cryptococcus gatti,1,9,2,3,0,15
Cryptococcus grubii,1,1,1,1,0,4
Cryptococcus neoformans,3,76,6,6,5,96
Cryptosporidium spp.,0,1,0,0,0,1
Curtobacterium flaccumfaciens,0,0,0,1,0,1
Cytomegalovirus（CMV）,1,24,6,1,6,38
"Dengue virus serotypes 1,2,3,and 4 ",12,8,70,59,40,189
Echo virus,1,20,25,4,5,55
Edwardsiella tarda,3,27,2,6,0,38
Eikenella corrodens,0,80,0,4,0,84
Elizabethkingia meningoseptica(Chryseobacterium meningosepticum),0,70,8,5,1,84
Empedobacter brevis,0,10,0,0,0,10
Entamoeba histolytica,1,1,1,0,0,3
Enterobacter aerogenes,10,69,14,5,15,113
Enterobacter asburiae,3,16,0,3,0,22
Enterobacter cancerogenus,0,8,0,2,0,10
Enterobacter cloacae,4,106,14,20,13,157
Enterobacter gergoviae,2,22,0,3,0,27
Enterobacter hormaechei,2,73,0,4,0,79
Enterobacter sakazakii,6,41,2,3,14,66
Enterobacter spp.,3,31,1,5,1,41
Enterobius spp.,0,1,0,0,0,1
Enterococcus avium,2,33,1,3,1,40
Enterococcus casseliflavus,2,110,1,4,0,117
Enterococcus dispar,0,2,0,0,0,2
Enterococcus durans,1,22,1,3,2,29
Enterococcus faecalis,21,235,39,37,44,376
Enterococcus faecium,3,96,15,12,14,140
Enterococcus flavescens,0,1,1,0,0,2
Enterococcus gallinarum,2,35,1,5,1,44
Enterococcus hirae,1,23,1,6,17,48
Enterococcus raffinosus,1,30,1,2,0,34
Enterococcus spp.,7,76,24,8,15,130
Enterovirus,62,72,58,27,36,255
Epidermophyton floccosum,0,3,3,2,3,11
Epidermophyton spp.,0,1,0,0,0,1
Epstein-Barr virus（EBV）,0,7,21,11,6,45
Erysipelothrix rhusiopathiae,5,31,4,5,4,49
Escherichia coli,62,471,206,56,395,1190
Escherichia fergusonii,1,11,0,4,0,16
Escherichia hermannii,1,16,1,4,1,23
Escherichia vulneris,1,10,0,3,0,14
Exophiala dermatitidis,0,10,0,4,0,14
Fasciola spp.,1,0,0,0,0,1
Fonsecaea pedrosoi,0,11,0,1,0,12
Francisella tularensis attenuated/vaccine strain,0,0,1,0,0,1
Fusarium moniliforme,0,1,1,0,0,2
Fusarium solani,0,2,0,0,0,2
Fusobacterium necrogenes,0,10,0,1,0,11
Fusobacterium nucleatum,0,44,6,5,10,65
Fusobacterium spp.,0,32,1,0,0,33
Gardnerella vaginalis,1,9,6,5,6,27
Gemella morbillorum,0,17,0,2,1,20
Giardia spp.,0,1,3,0,0,4
Haemophilus aegyptius,0,2,0,0,0,2
Haemophilus ducreyi,0,1,0,0,0,1
Haemophilus influenzae,4,152,14,7,18,195
Haemophilus parainfluenzae,0,41,2,3,0,46
Haemophilus spp.,4,42,5,4,3,58
Hafnia alvei,1,16,0,4,1,22
Helicobacter pylori,1,11,19,17,14,62
Hepatitis A virus,3,2,2,0,3,10
Hepatitis B virus,0,7,16,6,3,32
Hepatitis C virus,0,14,14,3,5,36
Hepatitis D virus,0,0,4,1,0,5
Hepatitis E virus,1,0,1,0,0,2
Herpes simplex viruses type 1and 2,1,24,20,4,17,66
Herpesvirus,0,10,0,0,6,16
Herpesvirus,0,0,0,0,4,4
Herpesvirus zoster,0,3,1,1,0,5
"Human herpesvirus type 6,7,8",0,2,2,0,3,7
Human metapneumovirus,1,11,3,0,5,20
Human Parvovirus(B19),0,0,0,0,1,1
Human rhinovirus,2,1,6,2,0,11
Hymenolepis spp.,0,1,0,0,0,1
Influenza virus type A,1,6,50,49,97,203
Influenza virus type A（subtype H1N1）,1,9,31,8,65,114
Influenza virus type A（subtype H5N1 vaccine strain）,0,0,4,4,6,14
Influenza virus type A（subtype H7N9 vaccine strain）,1,0,1,5,9,16
"Influenza virus type A, B, C",10,29,70,27,101,237
Japanese encephalitis virus,11,3,47,13,14,88
Kingella denitrificans,0,10,0,0,0,10
Kingella spp.,0,10,1,2,0,13
Klebsiella aerogenes,0,8,0,0,1,9
Klebsiella oxytoca,4,73,7,6,3,93
Klebsiella ozaenae,1,23,1,3,1,29
Klebsiella pneumoniae,8,270,50,19,74,421
Klebsiella spp.,6,39,26,31,13,115
Kluyvera ascorbata,1,10,0,3,1,15
Kluyvera cryocrescens,0,7,0,3,1,11
Kluyvera intermedia,0,4,0,2,1,7
Kocuria kristinae,1,9,1,1,1,13
Leclercia adecarboxylata,1,15,0,3,0,19
Legionella anisa,1,0,1,1,0,3
Legionella birminghamensis,0,0,1,1,0,2
Legionella bozemanii,0,0,1,1,1,3
Legionella cincinnatiensis,0,0,0,1,1,2
Legionella feeleii,0,0,1,1,0,2
Legionella hackeliae,0,0,0,1,0,1
Legionella jordanis,0,0,1,1,2,4
Legionella lansingensis,0,0,0,1,0,1
Legionella longbeachae,0,1,1,1,0,3
Legionella pneumophila,4,11,9,1,19,44
Legionella sainthelensi,0,0,0,1,0,1
Legionella spp.,2,7,6,4,2,21
Legionella tucsonensis,0,0,0,1,0,1
Legionella wadsworthii,0,0,0,1,0,1
Leishmania donovani,1,0,0,0,0,1
Leishmania spp.,0,0,8,0,0,8
Leptospira interrogans – all serotypes,1,1,36,0,0,38
Listeria ivanovii,3,0,3,3,3,12
Listeria monocytogenes,25,76,51,30,64,246
Mannheimia haemolytica,2,1,0,1,0,4
Mannheimia varigena,1,0,0,0,0,1
Measles virus,3,4,1,2,6,16
Microsporum spp.,0,10,2,5,4,21
Moellerella wisconsensis,0,1,0,0,0,1
Moraxella catarrhalis,0,68,5,3,9,85
Moraxella spp.,1,54,1,3,5,64
Morganella morganii,3,78,5,4,5,95
Mumps virus,3,0,1,1,5,10
Murine leukemia virus,0,2,0,2,9,13
Mycobacterium asiaticum,1,5,0,0,0,6
Mycobacterium avium complex,2,20,7,3,2,34
Mycobacterium avium subsp. paratuberculosis,1,0,1,0,0,2
Mycobacterium bovis BCG vaccine strain,4,5,5,5,1,20
Mycobacterium chelonae,1,19,1,0,0,21
Mycobacterium fortuitum,2,29,5,2,1,39
Mycobacterium kansasii,1,20,5,1,0,27
Mycobacterium malmoense,1,1,0,0,0,2
Mycobacterium marinum,1,13,8,1,0,23
Mycobacterium scrofulaceum,1,9,0,0,0,10
Mycobacterium simiae,1,11,0,0,0,12
Mycobacterium spp.,3,47,27,2,5,84
Mycobacterium szulgai,1,10,0,0,0,11
Mycobacterium ulcerans,1,1,0,0,0,2
Mycobacterium xenopi,1,7,0,0,0,8
Mycoplasma fermentans,1,0,0,2,1,4
Mycoplasma genitalium,1,0,0,0,0,1
Mycoplasma pneumoniae,2,3,5,5,7,22
Mycoplasma spp.,0,1,3,1,13,18
Myroides odoratus,0,12,0,3,0,15
Naegleria fowleri,1,0,0,0,0,1
Neisseria gonorrhoeae,2,118,10,3,8,141
Neisseria lactamica,0,13,2,3,2,20
Neisseria meningitidis,4,38,4,7,9,62
Neisseria spp.,0,46,3,4,7,60
Newcastle disease virus,3,0,4,1,14,22
Nocardia  otitidiscaviarum,1,3,0,0,0,4
Nocardia asteroides,1,9,1,0,0,11
Nocardia brasiliensis,1,5,0,0,0,6
Nocardia spp.,3,58,3,0,0,64
Nocardia transvalensis,1,0,0,0,0,1
Norovirus,4,1,2,1,3,11
Ochrobactrum anthropi,0,22,1,3,1,27
Ochroconis gallopava,0,3,0,0,0,3
Olsenella uli,0,1,0,1,0,2
Orbivirus,0,0,2,1,0,3
Orf virus,1,0,9,0,0,10
Paenibacillus popilliae,0,4,0,1,0,5
Pantoea agglomerans,3,27,2,3,0,35
Papillomaviruses,0,5,4,0,2,11
Parabacteroides goldsteinii,0,1,1,3,1,6
"Parainfluenza virus type1, 2, 3, and 4",2,24,14,8,16,64
Pasteurella multocida,0,27,0,1,1,29
Pasteurella spp.,2,34,0,4,7,47
Penicillium marneffei,0,16,2,1,1,20
Peptostreptococcus anaerobius,0,43,0,1,6,50
Peptostreptococcus spp.,0,34,0,2,0,36
Phialophora verrucosa,0,8,0,1,0,9
Photobacterium damsela,2,0,0,3,0,5
Plesiomonas shigelloides,3,35,4,3,1,46
Poliovirus（attenuated strain）,1,0,0,0,0,1
Poliovirus(vaccine like strain),3,0,0,0,0,3
Porphyromonas asaccharolytica,0,5,0,4,0,9
Porphyromonas gingivalis,0,8,17,6,14,45
Prevotella bivia,0,21,1,0,0,22
Prevotella buccae,0,13,0,2,0,15
Prevotella melaninogenica,0,21,3,2,0,26
Prevotella oralis,0,11,0,2,0,13
Prevotella spp.,0,32,5,5,2,44
Propionibacterium acnes,1,45,13,5,31,95
Proteus mirabilis,4,91,14,6,14,129
Proteus penneri,2,31,3,4,2,42
Proteus spp.,4,13,3,3,3,26
Proteus vulgaris,3,63,12,7,4,89
Providencia alcalifaciens,3,12,3,3,0,21
Providencia rettgeri,3,45,5,4,1,58
Providencia spp.,1,13,2,3,2,21
Providencia stuartii,2,43,4,4,1,54
Pseudallescheria boydii,0,5,0,1,0,6
Pseudomonas aeruginosa,36,242,84,124,369,855
Pseudomonas alcaligenes,0,19,2,3,1,25
Pseudomonas fluorescens,3,34,3,2,10,52
Pseudomonas luteola,0,11,0,2,2,15
Pseudomonas oryzihabitans,0,28,0,3,2,33
Rabies virus（all strain）,19,1,2,2,0,24
Rabies virus（vaccine strain）,0,0,0,0,1,1
Ralstonia pickettii,0,5,0,0,0,5
Ralstonia pickettii,0,18,0,0,3,21
Respiratory syncytial virus,3,28,17,9,39,96
Rhinovirus,2,6,3,2,8,21
Rhodococcus equi,18,40,4,5,27,94
Rift Valley Fever/ Zinga virus（vaccine strain MP-12）,1,0,0,0,0,1
Ross river virus,1,0,0,0,0,1
Rotavirus,3,0,3,0,2,8
Rubella virus,3,0,3,1,1,8
Salmonella arizonae,3,11,1,3,1,19
Salmonella cholerasuis,4,34,7,2,6,53
Salmonella enteritidis,8,49,4,7,41,109
Salmonella gallinarum–pullorum,4,0,4,0,0,8
"Salmonella paratyphi A, B, C",6,56,2,3,2,69
Salmonella spp.,47,215,56,30,167,515
Salmonella typhi,7,59,3,4,5,78
Salmonella typhimurium,34,31,31,23,84,203
Sapovirus,2,0,1,0,0,3
Scedosporium apiospermum,0,3,0,0,0,3
Scedosporium prolificans,0,7,0,1,0,8
Schistosoma mansoni,0,0,1,0,0,1
Serratia liquefaciens,2,24,2,3,1,32
Serratia marcescens,4,102,17,9,9,141
Serratia rubidaea,0,8,2,3,1,14
Shewanella alga,0,33,2,2,0,37
Shigella boydii,4,36,3,2,3,48
Shigella dysenteriae,4,9,3,5,2,23
Shigella flexneri,7,75,10,5,13,110
Shigella sonnei,5,99,6,5,6,121
Shigella spp.,4,23,2,3,1,33
Sindbis virus,1,0,3,1,2,7
Sphaerophorus necrophorus,0,1,0,0,0,1
Sphingobacterium multivorum,0,16,0,3,0,19
Sphingobacterium spiritivorum,0,16,0,3,0,19
Sphingobacterium thalpophilum,0,3,0,0,1,4
Sphingomonas paucimobilis,0,46,0,4,3,53
Sporothrix schenckii,0,11,0,3,1,15
Staphylococcus aureus,50,496,216,132,498,1392
Staphylococcus caprae,0,28,3,4,1,36
Staphylococcus epidermidis,5,100,30,23,89,247
Staphylococcus haemolyticus,2,37,3,5,2,49
Staphylococcus hyicus,1,3,1,3,0,8
Staphylococcus intermedius,0,7,2,3,1,13
Staphylococcus lugdunensis,2,52,2,4,2,62
Staphylococcus saprophyticus,1,115,10,4,5,135
Stenotrophomonas maltophilia,2,141,22,7,11,183
Streptobacillus moniliformis,1,5,0,1,0,7
Streptococcus  pyogenes,4,133,26,18,44,225
Streptococcus acidominimus,1,14,0,2,0,17
Streptococcus agalactiae,4,223,14,13,22,276
Streptococcus anginosus,1,47,3,2,3,56
Streptococcus bovis,1,46,2,3,2,54
Streptococcus canis,0,5,1,2,2,10
Streptococcus constellatus,1,45,1,2,2,51
Streptococcus dysgalactiae,3,45,2,5,3,58
Streptococcus equi,0,5,3,6,1,15
Streptococcus equinus,0,17,0,3,0,20
Streptococcus gallolyticus,1,37,1,2,0,41
Streptococcus iniae,3,0,5,4,4,16
Streptococcus intermedius,0,35,1,5,3,44
Streptococcus mitis,1,56,6,4,3,70
Streptococcus mutans,1,35,23,11,18,88
Streptococcus oralis,1,33,8,4,1,47
Streptococcus parasanguinis,1,36,4,5,2,48
Streptococcus pneumoniae,5,201,29,18,31,284
Streptococcus porcinus,0,7,0,4,0,11
Streptococcus salivarius,1,48,7,5,11,72
Streptococcus sanguinis,1,32,10,4,1,48
Streptococcus sobrinus,0,10,2,4,2,18
Streptococcus spp.,6,103,49,60,7,225
Streptococcus suis,3,14,5,6,1,29
Streptococcus uberis,0,11,0,3,1,15
Strongyloides spp.,1,1,0,0,0,2
Swine vesicular disease virus ,2,0,0,0,0,2
Taenia solium,0,1,0,0,0,1
Tannerella forsythia,0,0,0,0,1,1
Tatlockia maceachernii,0,0,0,2,0,2
Tatlockia micdadei,0,0,0,0,1,1
Toxoplasma gondii,1,0,1,0,0,2
Treponema pallidum,0,2,0,0,0,2
Trichinella spiralis,0,1,0,0,0,1
Trichomonas vaginalis,0,1,0,0,1,2
Trichophyton spp.,1,22,8,7,7,45
Vaccinia virus,3,6,8,5,2,24
Varicella zoster virus,2,11,0,0,2,15
Vesicular stomatitis virus-Indiana(VSV-Indiana),0,0,6,2,3,11
Vibrio alginolyticus,2,28,3,6,0,39
Vibrio cholerae,10,69,12,7,9,107
Vibrio cincinnatiensis,0,0,0,2,0,2
Vibrio fluvialis,2,22,0,4,0,28
Vibrio furnissii,1,4,0,2,0,7
Vibrio hollisae,0,0,1,0,0,1
Vibrio mimicus,2,15,1,4,1,23
Vibrio parahaemolyticus,29,50,61,11,25,176
Vibrio spp.,4,35,17,9,5,70
Vibrio vulnificus,5,65,14,8,3,95
Vittaforma cornea,1,2,0,0,0,3
Yellow fever virus (vaccine strain 17D),1,0,0,1,0,2
Yersinia enterocolitica,3,31,9,8,2,53
Yersinia intermedia,0,1,0,0,0,1
Yersinia pseudotuberculosis,1,3,3,4,0,11
Yersinia spp.,1,5,0,2,0,8
Yokenella regensburgei,2,2,0,1,0,5
Zika virus,3,4,28,15,4,54
